JJJJJJJJJJJJJJJJJJJJJJJJJJJJJJJJJJJJJJJJJJJJJJJJJJJJJJJJJJJJJJJJJJJJJJJJJJJJJJJJJJJJJJJJJJJJJJJJJJJJ
JJJJJJJJJJJJJJJJJJJJJJJJJJJJJJJJJJJJJJJJJJJJJJJJJJJJJJJJJJJJJJJJJJJJJJJJJJJJJJJJJJJJJJJJJJJJJJJJJJJJ
JJJJJJJJJJJJJJJJJJJJJJJJJJJJJJJJJJJJJJJJJJJJJJJJJJJJJJJJJJJJJJJJJJJJJJ:::::JJJJJJJJJJJJJJJJJJJJJJJJJ
JJJJJJJJJJJJJJJJJJJJJJJJJJJJJJJJJJJJJJJJJJJJJJJJJJJJJJJJJJJJJJJJJJ:::::::::::::JJJJJJJJJJJJJJJJJJJJJ
JJJJJJJJJJJJJJJJJJJJJJJJJJJJJJJJJJJJJJJJJJJJJJJJJJJJJJJJJJJJJJJJJJ::1222222222223:::::JJJJJJJJJJJJJJ
JJJJJJJJJJJJJJJJJJJJJJJJJJJJJJJJJJJJJJJJJJJJJJJJJJJJJJJJJJJJJJJ::::15555555555556::JJJJJJJJJJJJJJJJJ
JJJJJJJJJJJJJJJJJJJJJJJJJJJJJJJJJJJJJJJJJJJJJJJJJJJJJJJJJJJJJJJJJ:155555555bf5589:::::JJJJJJJJJJJJJJ
JJJJJJJJJJJJJJJJJJJJJJJJJJJJJJJJJJJJJJJJJJJJJJJJJJJJJJJJJJJJJJ:::15555555888889::::JJJJJJJJJJJJJJJJJ
JJJJJJJJJJJJJJJJJJJJJJJJJJJJJJJJJJJJJJJJJJJJJJJJJJJJJJJJJJJJJ::::45555559::::::::JJJJJJJJJJJJJJJJJJJ
JJJJJJJJJJJJJJJJJJJJJJJJJJJJJJJJJJJJJJJJJJJJJJJJJJJJJJJJJJJJJ::::4555559::::::JJJJJJJJJJJJJJJJJJJJJJ
JJJJJJJJJJJJJJJJJJJJJJJJJJJJJJJJJJJJJJJJJJJJJJJJJJJJJJJJJJJJJ::::455589:::::JJJJJJJJJJJJJJJJJJJJJJJJ
JJJJJJJJJJJJJJJJJJJJJJJJJJJJJJJJJJJJJJJJJJJJJJJJJJJJJJJJJJJJ::::15589::::JJJJJJJJJJJJJJJJJJJJJJJJJJJ
JJJJJJJJJJJJJJJJJJJJJJJJJJJJJJJJJJJJJJJJJJJJJJJJJJJJJJJJJJJ:::12556:::::JJJJJJJJJJJJJJJJJJJJJJJJJJJJ
JJJJJJJJJJJJJJJJJJJJJJJJJJJJJJJJJJJJJJJJJJJJJJJJJJJJJJJJJJ::::45556::::JJJJJJJJJJJJJJJJJJJJJJJJJJJJJ
JJJJJJJJJJJJJJJJJJJJJJJJJJJJJJJJJJJJJJJJJJJJJJJJJJJJJJJJJJ::::45556::::JJJJJJJJJJJJJJJJJJJJJJJJJJJJJ
JJJJJJJJJJJJJJJJJJJJJJJJJJJJJJJJJJJJJJJJJJJJJJJJJJJJJJJJJJJ:::45556:::::JJJJJJJJJJJJJJJJJJJJJJJJJJJJ
JJJJJJJJJJJJJJJJJJJJJJJJJJJJJJJJJJJJJJJJJJJJJJJJJJJJJJJJJJ::::455553:::::JJJJJJJJJJJJJJJJJJJJJJJJJJJ
JJJJJJJJJJJJJJJJJJJJJJJJJJJJJJJJJJJJJJJJJJJJJJJJJJJJJJJJ:::1225555553:::::JJJJJJJJJJJJJJJJJJJJJJJJJJ
JJJJJJJJJJJJJJJJJJJJJJJJJJJJJJJJJJJJJJJJJJJ:::::::::::122225555555559:::::JJJJJJJJJJJJJJJJJJJJJJJJJ0
JJJJJJJJJJJJJJJJJJJJJJJJJJJJJJJJJJJJJJJJJJJJ:::::::12255555555555589:::::JJJJJJJJJJJJJJJJJJJJJJJJJJJ
JJJJJJJJJJJJJJJJJJJJJJJJJJJJJJJJJJJJJJJJJJJJJJ::::1555555555555589:::::::::JJJJJJJJJJJJJJJJJJJJJJJJJ
JJJJJJJJJJJJJJJJJJJJJJJJJJJJJJJJJJJJJJJJJJJJJ::::155555888888889:::::::::JJJJJJJJJJJJJJJJJJJJJJJJJJJ
JJJJJJJJJJJJJJJJJJJJJJJJJJJJJJJJJJJJJJJJJJJ::::12555556::::::::::::::JJJJJJJJJJJJJJJJJJJJJJJJJJJJJJJ
JJJJJJJJJJJJJJJJJJJJJJJJJJJJJJJJJJJJJJJJJJ::::155555556:::::::::::JJJJJJJJJJJJJJJJJJJJJJJJJJJJJJJJJJ
JJJJJJJJJJJJJJJJJJJJJJJJJJJJJJJJJJJJJJJJJJ::::455555556::::::::JJJJJJJJJJJJJJJJJJJJJJJJJJJJJJJJJJJJJ
JJJJJJJJJJJJJJJJJJJJJJJJJJJJJJJJJJJJJJJJJJ::::455558889::::JJJJJJJJJJJJJJJJJJJJJJJJJJJJJJJJJJJJJJJJJ
JJJJJJJJJJJJJJJJJJJJJJJJJJJJJJJJJJ::::::::::1255556:::::JJJJJJJJJJJJJJJJJJJJJJJJJJJJJJJJJJJJJJJJJJJJ
JJJJJJJJJJJJJJJJJJJJJJJJJJJJJJJJJJJJJJJ::1225558889:::::JJJJJJJJJJJJJJJJJJJJJJJJJJJJJJJJJJJJJJJJJJJJ
JJJJJJJJJJJJJJJJJJJJJJJJJJJJJJJJJJJJJ::::455559::::::JJJJJJJJJJJJJJJJJJJJJJJJJJJJJJJJJJJJJJJJJJJJJJJ
JJJJJJJJJJJJJJJJJJJJJJJJJJJJJJJJJJJJ::::155559::::::JJJJJJJJJJJJJJJJJJJJJJJJJJJJJJJJJJJJJJJJJJJJJJJJ
JJJJJJJJJJJJJJJJJJJJJJJJJJJJJJJJJJJJ::::45556::::::JJJJJJJJJJJJJJJJJJJJJJJJJJJJJJJJJJJJJJJJJJJJJJJJJ
JJJJJJJJJJJJJJJJJJJJJJJJJJJJJJJJJJJJ::::45556:::::JJJJJJJJJJJJJJJJJJJJJJJJJJJJJJJJJJJJJJJJJJJJJJJJJJ
JJJJJJJJJJJJJJJJJJJJJJJJJJJJJJJJJJJ::::155556::::JJJJJJJJJJJJJJJJJJJJJJJJJJJJJJJJJJJJJJJJJJJJJJJJJJJ
JJJJJJJJJJJJJJJJJJJJJJJJJJJJJJJJJJJJ:::455556:::::JJJJJJJJJJJJJJJJJJJJJJJJJJJJJJJJJJJJJJJJJJJJJJJJJJ
JJJJJJJJJJJJJJJJJJJJJJJJJJJJJJJJJJ::::15555553::::::::JJJJJJJJJJJJJJJJJJJJJJJJJJJJJJJJJJJJJJJJJJJJJJ
JJJJJJJJJJJJJJJJJJJJJJJJJJJJJJJJJJ:::155555556:::::::::::::JJJJJJJJJJJJJJJJJJJJJJJJJJJJJJJJJJJJJJJJJ
JJJJJJJJJJJJJJJJJJJJJJJJJJJJJJJJ:::::4555555553:::::::::::::::JJJJJJJJJJJJJJJJJJJJJJJJJJJJJJJJJJJJJJ
JJJJJJJJJJJJJJJJJJJJJJJJJJJJJJJJ:::::45555555553:::g:::::::::::::::JJJJJJJJJJJJJJJJJJJJJJJJJJJJJJJJJ
JJJJJJJJJJJJJJJJJJJJJJJJJJJJJJJJJJJ::7855555555523:::::::::::::::JJJJJJJJJJJJJJJJJJJJJJJJJJJJJJJJJJJ
JJJJJJJJJJJJJJJJJJJJJJJJJJJJJJJJJJJ::::7555555555522223::::::::::JJJJJJJJJJJJJJJJJJJJJJJJJJJJJJJJJJJ
JJJJJJJJJJJJJJJJJJJJJJJJJJJJJJJJJJJJJJJ:7888855555555553:::::::JJJJJJJJJJJJJJJJJJJJJJJJJJJJJJJJJJJJJ
JJJJJJJJJJJJJJJJJJJJJJJJJJJJJJJJJJJJJJJ::::::788555555553:::::JJJJJJJJJJJJJJJJJJJJJJJJJJJJJJJJJJJJJJ
JJJJJJJJJJJJJJJJJJJJJJJJJJJJJJJJJJJJJJJJJJJJJ:::755555559::::JJJJJJJJJJJJJJJJJJJJJJJJJJJJJJJJJJJJJJJ
JJJJJJJJJJJJJJJJJJJJJJJJJJJJJJJJJJJJJJJJJJJJJJ:::4555559::::JJJJJJJJJJJJJJJJJJJJJJJJJJJJJJJJJJJJJJJJ
JJJJJJJJJJJJJJJJJJJJJJJJJJJJJJJJJJJJJJJJJJJJ::::1555559::::::JJJJJJJJJJJJJJJJJJJJJJJJJJJJJJJJJJJJJJJ
JJJJJJJJJJJJJJJJJJJJJJJJJJJJJJJJJJJJJJJJJJJJ::::755556::::JJJJJJJJJJJJJJJJJJJJJJJJJJJJJJJJJJJJJJJJJJ
JJJJJJJJJJJJJJJJJJJJJJJJJJJJJJJJJJJJJJJJJJJJJ::::755553::::QJJJJJJJJJJJJJJJJJJJJJJJJJJJJJJJJJJJJJJJJ
JJJJJJJJJJJJJJJJJJJJJJJJJJJJJJJJJJJJJJJJJJJJJJ::::755553::::QJJJJJJJJJJJJJJJJJJJJJJJJJJJJJJJJJJJJJJJ
JJJJJJJJJJJJJJJJJJJJJJJJJJJJJJJJJJJJJJJJJJJJJJJ::::7555523:::QJJJJJJJJJJJJJJJJJJJJJJJJJJJJJJJJJJJJJJ
JJJJJJJJJJJJJJJJJJJJJJJJJJJJJJJJJJJJJJJJJJJJJJJJ::::755556:::::JJJJJJJJJJJJJJJJJJJJJJJJJJJJJJJJJJJJJ
JJJJJJJJJJJJJJJJJJJJJJJJJJJJJJJJJJJJJJJJJJJJJJJJJ::::75556:::::QJJJJJJJJJJJJJJJJJJJJJJJJJJJJJJJJJJJJ
JJJJJJJJJJJJJJJJJJJJJJJJJJJJJJJJJJJJJJJJJJJJJJJJJJ::::455b3:::::QJJJJJJJJJJJJJJJJJJJJJJJJJJJJJJJJJJJ
JJJJJJJJJJJJJJJJJJJJJJJJJJJJJJJJJJJJJJJJJJJJJJ<<<<<<<<45556<<<<<<NJJJJJJJJJJJJJJJJJJJJJJJJJJJJJJJJJJ
JJJJJJJJJJJJJJJJJJJJJJJJJJJJJJJJJJJJJJJJJJJJJJ<<<<<<<<45556<<<<<<QJJJJJJJJJJJJJJJJJJJJJJJJJJJ9JJJJJJ
JJJJJJJJJJJJJJJJJJJJJJJJJJJJJJJJJJJJJJJJJJJJJJJ<<<<<<<78889<<<<<<<JJJJJJJJJJJJJJJJJJJJJJJJJJJJJJJJJJ
JJJJJJJJJJJJJJJJJJJJJJJJJJJJJJJJJJJJJJJJJJJJJJJ<<<<<<<<KLLM<<<<<<<QJJJJJJJJJJJJJJJJJJJJJJJJJJJJJJJJJ
JJJJJJJJJJJJJJJJJJJJJJJJJJJJJJJJJJJJJJJJJJJJJJJJ<<<<<<<NOOP<<<<<<<<QJJJJJJJJJJJJJJJJJJJJJJJJJJJJJJJJ
JJJJJJJJJJJJJJJJJJJJJJJJJJJJJJJJJJJJJJJJJJJJJJJJJ<<<<<<QOOP<<<<<<<<<NJJJJJJJJJJJJJJJJJJJJJJJJJJJJJJJ
JJJJJJJJJJJJJJJJJJJJJJJJJJJJJJJJJJJJJJJJJJJJJJJJJ<<<<<<<NOOM<<<<<<<<NJJJJJJJJJJJJJJJJJJJJJJJJJJJJJJJ
JJJJJJJJJJJJJJJJJJJJJJJJJJJJJJJJJJJJJJJJJJJJJJJJJ<<<<<<<NOOP<<<<<<<<NJJJJJJJJJJJJJJJJJJJJJJJJJJJJJJJ
JJJJJJJJJJJJJJJJJJJJJJJJJJJJJJJJJJJJJJJJJJJJJJJJJ<<<<<<<NOOP<<<<<<<<QJJJJJJJJJJJJJJJJJJJJJJJJJJJJJJJ
JJJJJJJJJJJJJJJJJJJJJJJJJJJJJJJJJJJJJJJJ<<<<<<<<<<<<<<<<NOOP<<<<<<<<<<<JJJJJJJJJJJJJJJJJJJJJJJJJJJJJ
JJJJJJJJJJJJJJJJJJJJJJJJJJJJJJJJ<<<<<d<<<<<<<<<<<<<<<<<<QRRS<<<<<<<<<<<<<<<NJJJJJJJJJJJJJJJJJJJJJJJJ
JJJJJJJJJJJJJJJJJJJJJJJJJJJJJJJJ<<<<<<<<<<<<<<<<<<<<<<<<<<<<<<<<<<<<<<<<<<<NJJJJJJJJJJJJJJJJJJJJJJJJ
JJJJJJJJJJJJJJJJJJJJJJJJJJJJJJJJ<<<<<<<<<<<<<<d<<<<<<<<<<<<<<<<<<<<<<<<<<<<NJJJJJJJJJJJJJJJJJJJJJJJJ
JJJJJJJJJJJJJJJJJJJJJJJJJJJJJJJJ<<<<<<<<<<<<<<<<<<<<KLM<<<<<<<<<<<<<<<<<<<<QJJJJJJJJJJJJJJJJJJJJJJJJ
JJJJJJJJJJJJJJJJJJJJJJJJJJJJ<<<<<<<<<<<<<<<<<<<<<<<<NOP<<<<<<<<<<d<<<<<<<<<<QJJJJJJJJJJJJJJJJJJJJJJJ
JJJJJJJJJJJJJJJJJJJJJJ<<d<<<<<<<<<<<<<<<<<<<<<<<<<<<QRS<<<<<<<<<<<<<<<<<<<<<<<<<<QJJJJJJJJJJJJJJJJJJ
JJJJJJJJJJJJJJJJJJJJJJJJJ<<<<<<<<<<<<<<<<<<<<<<<<<<<<<<<<<<<<<<<<<<<<<<<<<<<<<<<<<<<NJJJJJJJJJJJJJJJ
JJJJJJJJJJJJJJJJJJJJ<<<<<<<KM<<<<<<<<<<<<<<<<<<<<<<<<<<<<<<<<<<<<<<<<d<<<<<<<<<QJJJJJJJJJJJJJJJJJJJJ
JJJJJJJJJJJJJJ<<<<<<<<<<<<<QS<<<<<d<<<<<<<<<<<<<<<<<<<<<<<d<<<<<<<<<<<<<<JJJJJJJJJJJJJJJJJJJJJJJJJJJ
JJJJJJJJJJJJJJJJJJ<<<<<<<<<<<<<<<<<<<<<<<<<<<d<<<<<<<<<<<<<<<<<<<<<<<<<<<QJJJJJJJJJJJJJJJJJJJJJJJJJJ
JJJJJJJJJJJJJJJJJJ<<<<<d<<<<<<<<<<<<<<<<<<<<<<<<<<<<<<<<<<<d<<<<<<<<<<<<<<<<<NJJJJJJJJJJJJJJJJJJJJJJ
JJJJJJJJJJJJJJJJJJ<<<<<<<<<<<<<<<<<<<<<<<<<<<<<<<<<<<<<<<<<<<<<<<<<<<<<<<<<<<QJJJJJJJJJJJJJJJJJJJJJJ
JJJJJJJJJJJJJJJJJJJJJ<<<<<<<<<<<<<<<d<<<<<<<<<<<<<<<<<<<<<<<<<<<<<<<<<<<<<<<<<<<NJJJJJJJJJJJJJJJJJJJ
JJJJJJJJJJJJJ<<<<<<<<<<<<<<<<<<<<<<<<<<<<<KM<<<<<<<<<<<<<<<<<<<d<<<<<<<<<<<<<<<<<<<<JJJJJJJJJJJJJJJJ
JJJJJJJJJJJJ<<<<<<<<<<<<<<<<<<<<<<<<<<<<<<QS<<<<<<<<<<<<<<<<<<<<<<<<<<<<<KM<<<<<<<<<<JJJJJJJJJJJJJJJ
JJJJJJJJJJJ<<<<<<<J<<<<<<<<<d<<<<<<<<<<<<<<<<<<<<<<<<<<<<<<<<<<<<<<<<<<<<QS<<<<<<<<<<<JJJJJJJJJJJJJJ
JJJJJJJJJJ<<<<<<<<J<<<<<<<<<<<<<<<<<<<<<<<<<<<<<d<<<<<<<<<<<<<<<<<<<<<d<<<<<<<<<<<<<<<<JJJJJJJJJJJJJ
JJJJJJJJJ<<<<<<<<<J<<<<<<<<<<<<<<<d<<<<<<<<<<<<<<<<<<<<<<<<<<<<<<<<<<<<<<<<<<<<<<<<<<<<<JJJJJJJJJJJJ
JJJJJJJJ<<<<<<<<<<J<<<<<<<<<<<<<<<<<<<<<<<<<<<<<<<<<<<<<<<<<<<<<<<d<<<<<<<<<<<<<<<<<<<<<<JJJJJJJJJJJ
JJJJJJJ<<<<<<<<<<<<<<<<<<<<<<<<<<<<<<<<<<<<<<<*<<<<<<<<<<<<<<<<<<<<<<<<<<<<<<<<<<<<<<<<<<<JJJJJJJJJJ
:::::::<<<<<<<<<<<<<<<<<<<<<<<<<<<<<<<<<<<<<<<<<<<<<<<<KM<<<<<<<<<<<<<<<<<<<<<<<<<<<<<<<<<::::::::::
::::::::<<<<<<<<<<<<<<<<<<<<<<<<<<<<<<<<<<<<<<<<<<<<<<<QS<<<<<<<<<<<<<<<<<<<<<<<<<<<<<<<<:::::::::::
:::::::::<<<<<<<<<<<<<<<<<<<<<<<<<<<<<<<<<<<<<<<<<<<<<<<<<<<<<<<<<<<<<<<<<<<<<<<<<<<<<<<<<<<<<<<<<<<
=AAAAAAAAAAAAAAAAAAAAAAAAAAAAAAAAAAAAAAAAA?0000000:000000=AAAAAAAAAAAAAAAAAAAAAAAAAAAAAAAAAAAAAAAAA?
FEDEDEDEDEDEDEDEDEDEDEDEDEDEDDEDEDEDEDEDEDG::::0::::0::::FEDEDEDEDEDEDEDEDEDEDEDEDEDEDDEDEDEDEDEDEDG
FEDEDEDEDEDEDEDEDEDEDEDEDEDEDDEDEDEDEDEDEDG::::122223::J:FEDEDEDEDEDEDEDEDEDEDEDEDEDEDDEDEDEDEDEDEDG
FEDEDEDEDEDEDEDEDEDEDEDEDEDEDDEDEDEDEDEDEDG::::455556::::FEDEDEDEDEDEDEDEDEDEDEDEDEDEDDEDEDEDEDEDEDG
FEDEDEDEDEDEDEDEDEDEDEDEDEDEDDEDEDEDEDEDEDG:J::455556::::FEDEDEDEDEDEDEDEDEDEDEDEDEDEDDEDEDEDEDEDEDG
FEDEDEDEDEDEDEDEDEDEDEDEDEDEDDEDEDEDEDEDEDG::::455556::::FEDEDEDEDEDEDEDEDEDEDEDEDEDEDDEDEDEDEDEDEDG
FEDEDEDEDEDEDEDEDEDEDEDEDEDEDDEDEDEDEDEDEDG::::455556::::FEDEDEDEDEDEDEDEDEDEDEDEDEDEDDEDEDEDEDEDEDG
FEDEDEDEDEDEDEDEDEDEDEDEDEDEDDEDEDEDEDEDEDG::J:455556::::FEDEDEDEDEDEDEDEDEDEDEDEDEDEDDEDEDEDEDEDEDG
FEDEDEDEDEDEDEDEDEDEDEDEDEDEDDEDEDEDEDEDEDG::::455556:0::FEDEDEDEDEDEDEDEDEDEDEDEDEDEDDEDEDEDEDEDEDG
FEDEDEDEDEDEDEDEDEDEDEDEDEDEDDEDEDEDEDEDEDG::::455556::::FEDEDEDEDEDEDEDEDEDEDEDEDEDEDDEDEDEDEDEDEDG
FEDEDEDEDEDEDEDEDEDEDEDEDEDEDDEDEDEDEDEDEDG::0:455556::::FEDEDEDEDEDEDEDEDEDEDEDEDEDEDDEDEDEDEDEDEDG
FEDEDEDEDEDEDEDEDEDEDEDEDEDEDDEDEDEDEDEDEDG::::455556::::FEDEDEDEDEDEDEDEDEDEDEDEDEDEDDEDEDEDEDEDEDG
FEDEDEDEDEDEDEDEDEDEDEDEDEDEDDEDEDEDEDEDEDG::::455556::::FEDEDEDEDEDEDEDEDEDEDEDEDEDEDDEDEDEDEDEDEDG
FEDEDEDEDEDEDEDEDEDEDEDEDEDEDDEDEDEDEDEDEDG::::455556:::0FEDEDEDEDEDEDEDEDEDEDEDEDEDEDDEDEDEDEDEDEDG
FEDEDEDEDEDEDEDEDEDEDEDEDEDEDDEDEDEDEDEDEDG:0::455556:0::FEDEDEDEDEDEDEDEDEDEDEDEDEDEDDEDEDEDEDEDEDG