0000000000000000000000000000000000000000000000000000000000000000000000000000000000000000000000000000
0000000000000000000000000000000000000000000000000000000000000000000000000000000000000000000000000000
0000000000000000000000000000000000000000000000000000000000000000000000000000000000000000000000000000
0000000000000000000000000000000000000000000000000000000000000000000000000000000000000000000000000000
0000000000000000000000000000000000000000000000000000000000000000000000000000000000000000000000000000
0000000000000000000000000000000000000000000000000000000000000000000000000000000000000000000000000000
0000000000000000000000000000000000000000000000000000000000000000000000000000000000000000000000000000
0000000000000000000000000000000000000000000000000000000000000000000000000000000000000000000000000000
::::::::::::::::::::::::::::::::::::::::::::::::::::::::::::::::::::::::::::::::::::::::::::::::::::
:::<<<<<<<<<<<<<<<<<<<<<<<<<<<<<<<<<<<<<<<<<<<<<<<<<<<<<<<<<<<<<<<<<<<<<<<<<<<<<<<<<<<<<<<<<<<<<::::
::::<<<<<<<<<<<<<<<<<<<<<<<<<<<<<<<<<<<<<<<<<<<<<<<<<<<<<<<<<<<<<<<<<<<<<<<<<<<<<<<<<<<<<<<<<<<:::::
::::<<<<<<<<<<<<<<<<<<<<<<<<<<<<<<<<<<<<<<<<<<<<<<<<<<<<<<<<<<<<<<<<<<<<<<<<<<<<<<<<<<<<<<<<<:::::::
:::::<<<<<<<<<<<<<<<<<<<<<<<<<<<<<<<<<<<<<<<<<<<<<<<<<<<<<<<<<<<<<<<<<<<<<<<<<<<<<<<<<<<<<<<::::::::
::::::<<<<<<<<<<<<<<<<<<<<<<<<<<<<<<<<<<<<<<<<<<<<<<<<<<<<<<<<<<<<<<<<<<<<<<<<<<<<<<<<<<<<<:::::::::
:::::::<<<<<<<<<<<<<<<<<<<<<<<<<<<<<<<<<<<<<<<<<<<<<<<<KM<<<<<<<<<<<<<<<<<<<<<<<<<<<<<<<<<::::::::::
::::::::<<<<<<<<<<<<<<<<<<<<<<<<<<<<<<<<<<<<<<<<<<<<<<<QS<<<<<<<<<<<<<<<<<<<<<<<<<<<<<<<<:::::::::::
:::::::::<<<<<<<<<<<<<<<<<<<<<<<<<<<<<<<<<<<<<<<<<<<<<<<<<<<<<<<<<<<<<<<<<<<<<<<<<<<<<<<::::::::::::
=AAAAAAAAAAAAAAAAAAAAAAAAAAAAAAAAAAAAAAAAA?JJJJJJJbJJJJJ:=AAAAAAAAAAAAAAAAAAAAAAAAAAAAAAAAAAAAAAAAA?
FEDEDEDEDEDEDEDEDEDEDEDEDEDEDDEDEDEDEDEDEDG::::0::::0::::FEDEDEDEDEDEDEDEDEDEDEDEDEDEDDEDEDEDEDEDEDG
FEDEDEDEDEDEDEDEDEDEDEDEDEDEDDEDEDEDEDEDEDG:0::122223:JJ:FEDEDEDEDEDEDEDEDEDEDEDEDEDEDDEDEDEDEDEDEDG
FEDEDEDEDEDEDEDEDEDEDEDEDEDEDDEDEDEDEDEDEDG::::455556:JJ:FEDEDEDEDEDEDEDEDEDEDEDEDEDEDDEDEDEDEDEDEDG
FEDEDEDEDEDEDEDEDEDEDEDEDEDEDDEDEDEDEDEDEDG:J::455556:::JFEDEDEDEDEDEDEDEDEDEDEDEDEDEDDEDEDEDEDEDEDG
FEDEDEDEDEDEDEDEDEDEDEDEDEDEDDEDEDEDEDEDEDG::::455556::::FEDEDEDEDEDEDEDEDEDEDEDEDEDEDDEDEDEDEDEDEDG
FEDEDEDEDEDEDEDEDEDEDEDEDEDEDDEDEDEDEDEDEDG::::455556::::FEDEDEDEDEDEDEDEDEDEDEDEDEDEDDEDEDEDEDEDEDG
FEDEDEDEDEDEDEDEDEDEDEDEDEDEDDEDEDEDEDEDEDG::J:455556::::FEDEDEDEDEDEDEDEDEDEDEDEDEDEDDEDEDEDEDEDEDG
FEDEDEDEDEDEDEDEDEDEDEDEDEDEDDEDEDEDEDEDEDG::::455556:0::FEDEDEDEDEDEDEDEDEDEDEDEDEDEDDEDEDEDEDEDEDG
FEDEDEDEDEDEDEDEDEDEDEDEDEDEDDEDEDEDEDEDEDG::::455556::::FEDEDEDEDEDEDEDEDEDEDEDEDEDEDDEDEDEDEDEDEDG
FEDEDEDEDEDEDEDEDEDEDEDEDEDEDDEDEDEDEDEDEDG:::04555d6::::FEDEDEDEDEDEDEDEDEDEDEDEDEDEDDEDEDEDEDEDEDG
FEDEDEDEDEDEDEDEDEDEDEDEDEDEDDEDEDEDEDEDEDG::::455556::::FEDEDEDEDEDEDEDEDEDEDEDEDEDEDDEDEDEDEDEDEDG
FEDEDEDEDEDEDEDEDEDEDEDEDEDEDDEDEDEDEDEDEDG::::455556::::FEDEDEDEDEDEDEDEDEDEDEDEDEDEDDEDEDEDEDEDEDG
FEDEDEDEDEDEDEDEDEDEDEDEDEDEDDEDEDEDEDEDEDG::::455556:::0FEDEDEDEDEDEDEDEDEDEDEDEDEDEDDEDEDEDEDEDEDG
FEDEDEDEDEDEDEDEDEDEDEDEDEDEDDEDEDEDEDEDEDG:0::455556:0::FEDEDEDEDEDEDEDEDEDEDEDEDEDEDDEDEDEDEDEDEDG
FEDEDEDEDEDEDEDEDEDEDEDEDEDEDDEDEDEDEDEDEDG::::455556::::FEDEDEDEDEDEDEDEDEDEDEDEDEDEDDEDEDEDEDEDEDG
FEDEDEDEDEDEDEDEDEDEDEDEDEDEDDEDEDEDEDEDEDG::::455556::::FEDEDEDEDEDEDEDEDEDEDEDEDEDEDDEDEDEDEDEDEDG
FEDEDEDEDEDEDEDEDEDEDEDEDEDEDDEDEDEDEDEDEDG:0::455556::J:FEDEDEDEDEDEDEDEDEDEDEDEDEDEDDEDEDEDEDEDEDG
FEDEDEDEDEDEDEDEDEDEDEDEDEDEDDEDEDEDEDEDEDG::::455556::::FEDEDEDEDEDEDEDEDEDEDEDEDEDEDDEDEDEDEDEDEDG
FEDEDEDEDEDEDEDEDEDEDEDEDEDEDDEDEDEDEDEDEDG::::455556::::FEDEDEDEDEDEDEDEDEDEDEDEDEDEDDEDEDEDEDEDEDG
FEDEDEDEDEDEDEDEDEDEDEDEDEDEDDEDEDEDEDEDEDG::::455556J:::FEDEDEDEDEDEDEDEDEDEDEDEDEDEDDEDEDEDEDEDEDG
FEDEDEDEDEDEDEDEDEDEDEDEDEDEDDEDEDEDEDEDEDG::J:455556::::FEDEDEDEDEDEDEDEDEDEDEDEDEDEDDEDEDEDEDEDEDG
FEDEDEDEDEDEDEDEDEDEDEDEDEDEDDEDEDEDEDEDEDG::::455556::::FEDEDEDEDEDEDEDEDEDEDEDEDEDEDDEDEDEDEDEDEDG
FEDEDEDEDEDEDEDEDEDEDEDEDEDEDDEDEDEDEDEDEDG::::455556::::FEDEDEDEDEDEDEDEDEDEDEDEDEDEDDEDEDEDEDEDEDG
FEDEDEDEDEDEDEDEDEDEDEDEDEDEDDEDEDEDEDEDEDG::::455556::0:FEDEDEDEDEDEDEDEDEDEDEDEDEDEDDEDEDEDEDEDEDG
FEDEDEDEDEDEDEDEDEDEDEDEDEDEDDEDEDEDEDEDEDG:0::455d56:00:FEDEDEDEDEDEDEDEDEDEDEDEDEDEDDEDEDEDEDEDEDG
FEDEDEDEDEDEDEDEDEDEDEDEDEDEDDEDEDEDEDEDEDG::::455556::::FEDEDEDEDEDEDEDEDEDEDEDEDEDEDDEDEDEDEDEDEDG
FEDEDEDEDEDEDEDEDEDEDEDEDEDEDDEDEDEDEDEDEDG::::455556::::FEDEDEDEDEDEDEDEDEDEDEDEDEDEDDEDEDEDEDEDEDG
FEDEDEDEDEDEDEDEDEDEDEDEDEDEDDEDEDEDEDEDEDG::::455556::::FEDEDEDEDEDEDEDEDEDEDEDEDEDEDDEDEDEDEDEDEDG
FEDEDEDEDEDEDEDEDEDEDEDEDEDEDDEDEDEDEDEDEDG::::455556:J::FEDEDEDEDEDEDEDEDEDEDEDEDEDEDDEDEDEDEDEDEDG
FEDEDEDEDEDEDEDEDEDEDEDEDEDEDDEDEDEDEDEDEDG::::455556::::FEDEDEDEDEDEDEDEDEDEDEDEDEDEDDEDEDEDEDEDEDG
FEDEDEDEDEDEDEDEDEDEDEDEDEDEDDEDEDEDEDEDEDG::0:455556::::FEDEDEDEDEDEDEDEDEDEDEDEDEDEDDEDEDEDEDEDEDG
FEDEDEDEDEDEDEDEDEDEDEDEDEDEDDEDEDEDEDEDEDG::::455556::::FEDEDEDEDEDEDEDEDEDEDEDEDEDEDDEDEDEDEDEDEDG
FEDEDEDEDEDEDEDEDEDEDEDEDEDEDDEDEDEDEDEDEDG::::455556::0:FEDEDEDEDEDEDEDEDEDEDEDEDEDEDDEDEDEDEDEDEDG
FEDEDEDEDEDEDEDEDEDEDEDEDEDEDDEDEDEDEDEDEDG::::455556::::FEDEDEDEDEDEDEDEDEDEDEDEDEDEDDEDEDEDEDEDEDG
FEDEDEDEDEDEDEDEDEDEDEDEDEDEDDEDEDEDEDEDEDG:J::455556::::FEDEDEDEDEDEDEDEDEDEDEDEDEDEDDEDEDEDEDEDEDG
FEDEDEDEDEDEDEDEDEDEDEDEDEDEDDEDEDEDEDEDEDG::::455556::::FEDEDEDEDEDEDEDEDEDEDEDEDEDEDDEDEDEDEDEDEDG
FEDEDEDEDEDEDEDEDEDEDEDEDEDEDDEDEDEDEDEDEDG0:::455d56:::0FEDEDEDEDEDEDEDEDEDEDEDEDEDEDDEDEDEDEDEDEDG
FEDEDEDEDEDEDEDEDEDEDEDEDEDEDDEDEDEDEDEDEDG:0::455556::0:>CBCBCBCBCBCBCBCBCBCBCBCBCBCBCBCBCBCBCBCBC@
FEDEDEDEDEDEDEDEDEDEDEDEDEDEDDEDEDEDEDEDEDG::0:4555552230::::J::::::::::::::::::::::::::::::::::::::
FEDEDEDEDEDEDEDEDEDEDEDEDEDEDDEDEDEDEDEDEDG:::0785555556000::::::::::::J:::::::::J::::::::::::::::::
FEDEDEDEDEDEDEDEDEDEDEDEDEDEDDEDEDEDEDEDEDG::::00788885523000000::::::::::::::::::::::::::::::::::::
FEDEDEDEDEDEDEDEDEDEDEDEDEDEDDEDEDEDEDEDEDG:::J::::000755522222300:::::::::=AAAAAAAAAAAAAAAAAAAAAAA?
FEDEDEDEDEDEDEDEDEDEDEDEDEDEDDEDEDEDEDEDEDG::::::J:::007555555552300J::::::FEDEDEDEDEDEDDEDEDEDEDEDG
FEDEDEDEDEDEDEDEDEDEDEDEDEDEDDEDEDEDEDEDEDG:::::::::J::078855555552230:::::FEDEDEDEDEDEDDEDEDEDEDEDG
FEDEDEDEDEDEDEDEDEDEDEDEDEDEDDEDEDEDEDEDEDG::::0:::::::::J0788885555530J:::FEDEDEDEDEDEDDEDEDEDEDEDG
FEDEDEDEDEDEDEDEDEDEDEDEDEDEDDEDEDEDEDEDEDG:::::::J:::J::::0J000785555230::FEDEDEDEDEDEDDEDEDEDEDEDG
FEDEDEDEDEDEDEDEDEDEDEDEDEDEDDEDEDEDEDEDEDG::::::::J00000J::::J00075555530:FEDEDEDEDEDEDDEDEDEDEDEDG
FEDEDEDEDEDEDEDEDEDEDEDEDEDEDDEDEDEDEDEDEDG:::::::012222230:::::::07555560:FEDEDEDEDEDEDDEDEDEDEDEDG
FEDEDEDEDEDEDEDEDEDEDEDEDEDEDDEDEDEDEDEDEDG::::::01555555530:::::::04555530FEDEDEDEDEDEDDEDEDEDEDEDG
FEDEDEDEDEDEDEDEDEDEDEDEDEDEDDEDEDEDEDEDEDG00:::01555885555230::J::04555560>CBCBCBCBCBCBCBCBCBCBCBC@
FEDEDEDEDEDEDEDEDEDEDEDEDEDEDDEDEDEDEDEDEDG::00015589007555560:::::0755555222222222222230:::J:::::::
FEDEDEDEDEDEDEDEDEDEDEDEDEDEDDEDEDEDEDEDEDG::12255900::04555530::J::045555888888888888890:::::J:::::
FEDEDEDEDEDEDEDEDEDEDEDEDEDEDDEDEDEDEDEDEDG:1555590::J:04555560:::::J455d60=AAAAAAAAAAAAAAAAAAAAAAA?
FEDEDEDEDEDEDEDEDEDEDEDEDEDEDDEDEDEDEDEDEDG155556J:::::0755555300::01555560FEDEDEDEDEDEDEDEDEDEDEDEG
FEDEDEDEDEDEDEDEDEDEDEDEDEDEDDEDEDEDEDEDEDG4555560::::J:0788855230004555590FEDEDEDEDEDEDEDEDEDEDEDEG
>CBCBCBCBCBCBCBCBCBCBCBCBCBCBCBCBCBCBCBCBC@4555560:::J:::JJ007555222555560:FEDEDEDEDEDEDEDEDEDEDEDEG
::::::::::::::::::::::::::::::::::::::::::J4555560:::::::::::075555555559J:FEDEDEDEDEDEDEDEDEDEDEDEG
::::::::::::::::::::::::::::::::::::J:::::04555560::::J:::::::07555555590::FEDEDEDEDEDEDEDEDEDEDEDEG
:::::::::::::::::::::::::::::::::::J:::::004d5589J:::::::::::J:078888890:::FEDEDEDEDEDEDEDEDEDEDEDEG
::::::::::::::::::::::::::::::::::::::::012555900::::::::J::::::00J000J::::FEDEDEDEDEDEDEDEDEDEDEDEG
::::::::::::::::::::::::::::::J::::::::01555590::::0::::::::::::::::::::J::FEDEDEDEDEDEDEDEDEDEDEDEG
::::::::::::::::::::::::::::J:::::::::01555590:::::::::::0::::0::J0::::::::FEDEDEDEDEDEDEDEDEDEDEDEG
:::::::::::::::::::::::::::::::::::::01555590::::J::::0:0:0J:0:00::00:0:J::FEDEDEDEDEDEDEDEDEDEDEDEG
:::::::::::::::::::::::::::::::J::::01555590::J::::::0:J::::0:::::J::0:::::FEDEDEDEDEDEDEDEDEDEDEDEG
::::::::::::::::::::::::::::::::::::0455560:::::::J:0::12222222222223:00:::FEDEDEDEDEDEDEDEDEDEDEDEG
::::::::::::::::::::::::::::::::::::04555530::::::00:::45555555555556:J:000FEDEDEDEDEDEDEDEDEDEDEDEG
::::::::::::::::::::::::::J:::::::::045*5560000J000::::45555555555556::0:J:>CBCBCBCBCBCBCBCBCBCBCBC@
::::::::::::::::::::::::::::::::::::0755555222222222222555555555555552222222222222230:::J:::::::::::
:::::::::::::::::::::::::::::::::::::075588888888888888888888888888888888888888888890:J:::J:::::::::
=AAAAAAAAAAAAAAAAAAAAAAAAAAAAAAAAAAAAA?46=AAAAAAAAAAAAAAAAAAAAAAAAAAAAAAAAAAAAAAAAAAAAAAAAAAAAAAAAA?
FEDEDEDEDEDEDEDEDEDEDEDEDEDEDDEDEDEDEDG46FEDEDEDEDEDEDEDEDEDEDEDEDEDEDDEDEDEDEDEDEDEDEDEDEDEDEDEDEDG
FEDEDEDEDEDEDEDEDEDEDEDEDEDEDDEDEDEDEDG46FEDEDEDEDEDEDEDEDEDEDEDEDEDEDDEDEDEDEDEDEDEDEDEDEDEDEDEDEDG
FEDEDEDEDEDEDEDEDEDEDEDEDEDEDDEDEDEDEDG46FEDEDEDEDEDEDEDEDEDEDEDEDEDEDDEDEDEDEDEDEDEDEDEDEDEDEDEDEDG
FEDEDEDEDEDEDEDEDEDEDEDEDEDEDDEDEDEDEDG46FEDEDEDEDEDEDEDEDEDEDEDEDEDEDDEDEDEDEDEDEDEDEDEDEDEDEDEDEDG
FEDEDEDEDEDEDEDEDEDEDEDEDEDEDDEDEDEDEDG46FEDEDEDEDEDEDEDEDEDEDEDEDEDEDDEDEDEDEDEDEDEDEDEDEDEDEDEDEDG
FEDEDEDEDEDEDEDEDEDEDEDEDEDEDDEDEDEDEDG79>CBCBCBCBCBCBCBCBCBCBCBCBCBCBCBCBCBCBCBCBCBCBCBCBCBCBCBCBC@
FEDEDEDEDEDEDEDEDEDEDEDEDEDEDDEDEDEDEDGJJ:::::::::::::::::::::::::::::::::::::::::::::::::::::::::::
FEDEDEDEDEDEDEDEDEDEDEDEDEDEDDEDEDEDEDG:::::::::::::::::::::::::::::::::::::::::::::::::::::::::::::
FEDEDEDEDEDEDEDEDEDEDEDEDEDEDDEDEDEDEDG:::::::::::::::::::::::::::::::::::::::::::::::::::::::::::::
FEDEDEDEDEDEDEDEDEDEDEDEDEDEDDEDEDEDEDG:::::::::::::::::::::::::::::::::::::::::::::::::::::::::::::
FEDEDEDEDEDEDEDEDEDEDEDEDEDEDDEDEDEDEDG:::::::::::::::::::::::::::::::::::::::::::::::::::::::::::::
::::::::::::::::::::::::::::::::::::::::::::::::::::::::::::::::::::::::::::::::::::::::::::::::::::
::::::::::::::::::::::::::::::::::::::::::::::::::::::::::::::::::::::::::::::::::::::::::::::::::::
::::::::::::::::::::::::::::::::::::::::::::::::::::::::::::::::::::::::::::::::::::::::::::::::::::