0000000000000000000000000000000000000000000000000000000000000000000000000000000000000000000000000000
0000000000000000000000000000000000000000000000000000000000000000000000000000000000000000000000000000
0000000000000000000000000000000000000000000000000000000000000000000000000000000000000000000000000000
0000000000000000000000000000000000000000000000000000000000000000000000000000000000000000000000000000
0000000000000000000000000000000000000000000000000000000000000000000000000000000000000000000000000000
0000000000000000000000000000000000000000000000000000000000000000000000000000000000000000000000000000
0000000000000000000000000000000000000000000000000000000000000000000000000000000000000000000000000000
0000000000000000000000000000000000000000000000000000000000000000000000000000000000000000000000000000
::::::::::::::::::::::::::::::::::::::::::::::::::::::::::::::::::::::::::::::::::::::::::::::::::::
:::<<<<<<<<<<<<<<<<<<<<<<<<<<<<<<<<<<<<<<<<<<<<<<<<<<<<<<<<<<<<<<<<<<<<<<<<<<<<<<<<<<<<<<<<<<<<<::::
::::<<<<<<<<<<<<<<<<<<<<<<<<<<<<<<<<<<<<<<<<<<<<<<<<<<<<<<<<<<<<<<<<<<<<<<<<<<<<<<<<<<<<<<<<<<<:::::
::::<<<<<<<<<<<<<<<<<<<<<<<<<<<<<<<<<<<<<<<<<<<<<<<<<<<<<<<<<<<<<<<<<<<<<<<<<<<<<<<<<<<<<<<<<:::::::
:::::<<<<<<<<<<<<<<<<<<<<<<<<<<<<<<<<<<<<<<<<<<<<<<<<<<<<<<<<<<<<<<<<<<<<<<<<<<<<<<<<<<<<<<<::::::::
::::::<<<<<<<<<<<<<<<<<<<<<<<<<<<<<<<<<<<<<<<<<<<<<<<<<<<<<<<<<<<<<<<<<<<<<<<<<<<<<<<<<<<<<:::::::::
:::::::<<<<<<<<<<<<<<<<<<<<<<<<<<<<<<<<<<<<<<<<<<<<<<<<<<<<<<<<<<<<<<<<<<<<<<<<<<<<<<<<<<<::::::::::
::::::::<<<<<<<<<<<<<<<<<<<<<<<<<<<<<<<<<<<<<<<<00<<<<<<<<<<<<<<<<<<<<<<<<<<<<<<<<<<<<<<<:::::::::::
:::::::::<<<<<<<<<<<<<<<<<<<<<<<<<<<<<<<<<<<0<<0<<0<<<<<<<<<<<<<<<<<<<<<<<<<<<<<<<<<<<<<::::::::::::
=AAAAAAAAAAAAAAAAAAAAAAAAAAAAAAAAAAAAAAAAA?0000000b000000=AAAAAAAAAAAAAAAAAAAAAAAAAAAAAAAAAAAAAAAAA?
FEDEDEDEDEDEDEDEDEDEDEDEDEDEDDEDEDEDEDEDEDG::::000::0::::FEDEDEDEDEDEDEDEDEDEDEDEDEDEDDEDEDEDEDEDEDG
FEDEDEDEDEDEDEDEDEDEDEDEDEDEDDEDEDEDEDEDEDG::::122223::::FEDEDEDEDEDEDEDEDEDEDEDEDEDEDDEDEDEDEDEDEDG
FEDEDEDEDEDEDEDEDEDEDEDEDEDEDDEDEDEDEDEDEDG::::455556::::FEDEDEDEDEDEDEDEDEDEDEDEDEDEDDEDEDEDEDEDEDG
FEDEDEDEDEDEDEDEDEDEDEDEDEDEDDEDEDEDEDEDEDG::::455556::::FEDEDEDEDEDEDEDEDEDEDEDEDEDEDDEDEDEDEDEDEDG
FEDEDEDEDEDEDEDEDEDEDEDEDEDEDDEDEDEDEDEDEDG::::455556::::FEDEDEDEDEDEDEDEDEDEDEDEDEDEDDEDEDEDEDEDEDG
FEDEDEDEDEDEDEDEDEDEDEDEDEDEDDEDEDEDEDEDEDG::::455556::::FEDEDEDEDEDEDEDEDEDEDEDEDEDEDDEDEDEDEDEDEDG
FEDEDEDEDEDEDEDEDEDEDEDEDEDEDDEDEDEDEDEDEDG::::455556::::FEDEDEDEDEDEDEDEDEDEDEDEDEDEDDEDEDEDEDEDEDG
FEDEDEDEDEDEDEDEDEDEDEDEDEDEDDEDEDEDEDEDEDG::::455556:0::FEDEDEDEDEDEDEDEDEDEDEDEDEDEDDEDEDEDEDEDEDG
FEDEDEDEDEDEDEDEDEDEDEDEDEDEDDEDEDEDEDEDEDG::::455556::::FEDEDEDEDEDEDEDEDEDEDEDEDEDEDDEDEDEDEDEDEDG
FEDEDEDEDEDEDEDEDEDEDEDEDEDEDDEDEDEDEDEDEDG::::455556::::FEDEDEDEDEDEDEDEDEDEDEDEDEDEDDEDEDEDEDEDEDG
FEDEDEDEDEDEDEDEDEDEDEDEDEDEDDEDEDEDEDEDEDG::::455556::::FEDEDEDEDEDEDEDEDEDEDEDEDEDEDDEDEDEDEDEDEDG
FEDEDEDEDEDEDEDEDEDEDEDEDEDEDDEDEDEDEDEDEDG::::455556::::FEDEDEDEDEDEDEDEDEDEDEDEDEDEDDEDEDEDEDEDEDG
FEDEDEDEDEDEDEDEDEDEDEDEDEDEDDEDEDEDEDEDEDG::::455556:::0FEDEDEDEDEDEDEDEDEDEDEDEDEDEDDEDEDEDEDEDEDG
FEDEDEDEDEDEDEDEDEDEDEDEDEDEDDEDEDEDEDEDEDG::::455556:0::FEDEDEDEDEDEDEDEDEDEDEDEDEDEDDEDEDEDEDEDEDG
FEDEDEDEDEDEDEDEDEDEDEDEDEDEDDEDEDEDEDEDEDG::::455556::::FEDEDEDEDEDEDEDEDEDEDEDEDEDEDDEDEDEDEDEDEDG
FEDEDEDEDEDEDEDEDEDEDEDEDEDEDDEDEDEDEDEDEDG::::455556::::FEDEDEDEDEDEDEDEDEDEDEDEDEDEDDEDEDEDEDEDEDG
FEDEDEDEDEDEDEDEDEDEDEDEDEDEDDEDEDEDEDEDEDG::::455556::0:FEDEDEDEDEDEDEDEDEDEDEDEDEDEDDEDEDEDEDEDEDG
FEDEDEDEDEDEDEDEDEDEDEDEDEDEDDEDEDEDEDEDEDG::::455556::::FEDEDEDEDEDEDEDEDEDEDEDEDEDEDDEDEDEDEDEDEDG
FEDEDEDEDEDEDEDEDEDEDEDEDEDEDDEDEDEDEDEDEDG::::455556::::FEDEDEDEDEDEDEDEDEDEDEDEDEDEDDEDEDEDEDEDEDG
FEDEDEDEDEDEDEDEDEDEDEDEDEDEDDEDEDEDEDEDEDG::::455556:::0FEDEDEDEDEDEDEDEDEDEDEDEDEDEDDEDEDEDEDEDEDG
FEDEDEDEDEDEDEDEDEDEDEDEDEDEDDEDEDEDEDEDEDG::::455556::::FEDEDEDEDEDEDEDEDEDEDEDEDEDEDDEDEDEDEDEDEDG
FEDEDEDEDEDEDEDEDEDEDEDEDEDEDDEDEDEDEDEDEDG::::455556::::FEDEDEDEDEDEDEDEDEDEDEDEDEDEDDEDEDEDEDEDEDG
FEDEDEDEDEDEDEDEDEDEDEDEDEDEDDEDEDEDEDEDEDG::::455556:0::FEDEDEDEDEDEDEDEDEDEDEDEDEDEDDEDEDEDEDEDEDG
FEDEDEDEDEDEDEDEDEDEDEDEDEDEDDEDEDEDEDEDEDG::::455556::::FEDEDEDEDEDEDEDEDEDEDEDEDEDEDDEDEDEDEDEDEDG
FEDEDEDEDEDEDEDEDEDEDEDEDEDEDDEDEDEDEDEDEDG::::455556::::FEDEDEDEDEDEDEDEDEDEDEDEDEDEDDEDEDEDEDEDEDG
FEDEDEDEDEDEDEDEDEDEDEDEDEDEDDEDEDEDEDEDEDG::::4555560:::FEDEDEDEDEDEDEDEDEDEDEDEDEDEDDEDEDEDEDEDEDG
FEDEDEDEDEDEDEDEDEDEDEDEDEDEDDEDEDEDEDEDEDG::::455556::::FEDEDEDEDEDEDEDEDEDEDEDEDEDEDDEDEDEDEDEDEDG
FEDEDEDEDEDEDEDEDEDEDEDEDEDEDDEDEDEDEDEDEDG::::455556::::FEDEDEDEDEDEDEDEDEDEDEDEDEDEDDEDEDEDEDEDEDG
FEDEDEDEDEDEDEDEDEDEDEDEDEDEDDEDEDEDEDEDEDG::::455556:0::FEDEDEDEDEDEDEDEDEDEDEDEDEDEDDEDEDEDEDEDEDG
FEDEDEDEDEDEDEDEDEDEDEDEDEDEDDEDEDEDEDEDEDG::::455556::::FEDEDEDEDEDEDEDEDEDEDEDEDEDEDDEDEDEDEDEDEDG
FEDEDEDEDEDEDEDEDEDEDEDEDEDEDDEDEDEDEDEDEDG::::455556::::FEDEDEDEDEDEDEDEDEDEDEDEDEDEDDEDEDEDEDEDEDG
FEDEDEDEDEDEDEDEDEDEDEDEDEDEDDEDEDEDEDEDEDG::::455556::::FEDEDEDEDEDEDEDEDEDEDEDEDEDEDDEDEDEDEDEDEDG
FEDEDEDEDEDEDEDEDEDEDEDEDEDEDDEDEDEDEDEDEDG::::455556::0:FEDEDEDEDEDEDEDEDEDEDEDEDEDEDDEDEDEDEDEDEDG
FEDEDEDEDEDEDEDEDEDEDEDEDEDEDDEDEDEDEDEDEDG::::455556::::FEDEDEDEDEDEDEDEDEDEDEDEDEDEDDEDEDEDEDEDEDG
FEDEDEDEDEDEDEDEDEDEDEDEDEDEDDEDEDEDEDEDEDG::::455556::::FEDEDEDEDEDEDEDEDEDEDEDEDEDEDDEDEDEDEDEDEDG
FEDEDEDEDEDEDEDEDEDEDEDEDEDEDDEDEDEDEDEDEDG::::455556::::FEDEDEDEDEDEDEDEDEDEDEDEDEDEDDEDEDEDEDEDEDG
FEDEDEDEDEDEDEDEDEDEDEDEDEDEDDEDEDEDEDEDEDG0:::455d56:::0FEDEDEDEDEDEDEDEDEDEDEDEDEDEDDEDEDEDEDEDEDG
FEDEDEDEDEDEDEDEDEDEDEDEDEDEDDEDEDEDEDEDEDG:0::455556::0:>CBCBCBCBCBCBCBCBCBCBCBCBCBCBCBCBCBCBCBCBC@
FEDEDEDEDEDEDEDEDEDEDEDEDEDEDDEDEDEDEDEDEDG::0:45555530::::J::::::::::::::::::::::::::::::::::::::::
FEDEDEDEDEDEDEDEDEDEDEDEDEDEDDEDEDEDEDEDEDG:::07855556000::::::J:::::::::J::::::::::::::::::::::::::
FEDEDEDEDEDEDEDEDEDEDEDEDEDEDDEDEDEDEDEDEDG::::0078855223000::::::::J:::::::::::::::::::::::::::::::
FEDEDEDEDEDEDEDEDEDEDEDEDEDEDDEDEDEDEDEDEDG:::J::000788882230000:::::::J:::=AAAAAAAAAAAAAAAAAAAAAAA?
FEDEDEDEDEDEDEDEDEDEDEDEDEDEDDEDEDEDEDEDEDG::::::J:::000078822230000:::::::FEDEDEDEDEDEDDEDEDEDEDEDG
FEDEDEDEDEDEDEDEDEDEDEDEDEDEDDEDEDEDEDEDEDG:::::::::J::::00078852223000::::FEDEDEDEDEDEDDEDEDEDEDEDG
FEDEDEDEDEDEDEDEDEDEDEDEDEDEDDEDEDEDEDEDEDG::::J:::::::::::J000788552230:::FEDEDEDEDEDEDDEDEDEDEDEDG
FEDEDEDEDEDEDEDEDEDEDEDEDEDEDDEDEDEDEDEDEDG:::::::J:::J::J:::::0007855530::FEDEDEDEDEDEDDEDEDEDEDEDG
FEDEDEDEDEDEDEDEDEDEDEDEDEDEDDEDEDEDEDEDEDG::::::::0000000::::J:::00455530:FEDEDEDEDEDEDDEDEDEDEDEDG
FEDEDEDEDEDEDEDEDEDEDEDEDEDEDDEDEDEDEDEDEDG:::::::012222230::::::J:07855530FEDEDEDEDEDEDDEDEDEDEDEDG
FEDEDEDEDEDEDEDEDEDEDEDEDEDEDDEDEDEDEDEDEDG::::::01555555530::::::::0045560FEDEDEDEDEDEDDEDEDEDEDEDG
FEDEDEDEDEDEDEDEDEDEDEDEDEDEDDEDEDEDEDEDEDG00:::004558855560::::J::01255560>CBCBCBCBCBCBCBCBCBCBCBC@
FEDEDEDEDEDEDEDEDEDEDEDEDEDEDDEDEDEDEDEDEDG::00012589007555230:::::0755555222222222222230::JJ:::::::
FEDEDEDEDEDEDEDEDEDEDEDEDEDEDDEDEDEDEDEDEDG::12255900::04555530::J::045555588888888888890:::::J:::::
FEDEDEDEDEDEDEDEDEDEDEDEDEDEDDEDEDEDEDEDEDG:1555590::J:04555590:::::0455d59=AAAAAAAAAAAAAAAAAAAAAAA?
FEDEDEDEDEDEDEDEDEDEDEDEDEDEDDEDEDEDEDEDEDG1555560:::::0788560000::0155556:FEDEDEDEDEDEDEDEDEDEDEDEG
FEDEDEDEDEDEDEDEDEDEDEDEDEDEDDEDEDEDEDEDEDG4555590::::J:000782223000455559:FEDEDEDEDEDEDEDEDEDEDEDEG
>CBCBCBCBCBCBCBCBCBCBCBCBCBCBCBCBCBCBCBCBC@455560:::J::::::007555222555560:FEDEDEDEDEDEDEDEDEDEDEDEG
::::::::::::::::::::::::::::::::::::::::::07555530:::::::::::0755555555590:FEDEDEDEDEDEDEDEDEDEDEDEG
::::::::::::::::::::::::::::::::::::J::::::0455560::::J:::::::07555555590::FEDEDEDEDEDEDEDEDEDEDEDEG
:::::::::::::::::::::::::::::::::::J:::::001d55890:::::::::::J:078888890:J:FEDEDEDEDEDEDEDEDEDEDEDEG
::::::::::::::::::::::::::::::::::::::::012555900::::::::J::::::0000000::::FEDEDEDEDEDEDEDEDEDEDEDEG
::::::::::::::::::::::::::::::J::::::::01555590::::J::::::::::::::::::::J::FEDEDEDEDEDEDEDEDEDEDEDEG
::::::::::::::::::::::::::::J:::::::::01555590:::::::::0:0:0::0::00:0::::::FEDEDEDEDEDEDEDEDEDEDEDEG
:::::::::::::::::::::::::::::::::::::01555590::::J:::0::0:00:0:00::00:0:J::FEDEDEDEDEDEDEDEDEDEDEDEG
:::::::::::::::::::::::::::::::J::::01555590::J::::::0:0::::0:::::J::0:::::FEDEDEDEDEDEDEDEDEDEDEDEG
::::::::::::::::::::::::::::::::::::0455560:::::::J:0::12222222222223:00:::FEDEDEDEDEDEDEDEDEDEDEDEG
::::::::::::::::::::::::::::::::::::04555530::::::00:::45555555555556:0:000FEDEDEDEDEDEDEDEDEDEDEDEG
::::::::::::::::::::::::::J:::::::::045P5b600000000::::45555555555556::0:J:>CBCBCBCBCBCBCBCBCBCBCBC@
::::::::::::::::::::::::::::::::::::0755555222222222222255555555555552222222222222230:::J:J:::::::::
:::::::::::::::::::::::::::::::::::::075588888888888888888888888888888888888888888890:J:::J:::::::::
=AAAAAAAAAAAAAAAAAAAAAAAAAAAAAAAAAAAAA?46=AAAAAAAAAAAAAAAAAAAAAAAAAAAAAAAAAAAAAAAAAAAAAAAAAAAAAAAAA?
FEDEDEDEDEDEDEDEDEDEDEDEDEDEDDEDEDEDEDG46FEDEDEDEDEDEDEDEDEDEDEDEDEDEDDEDEDEDEDEDEDEDEDEDEDEDEDEDEDG
FEDEDEDEDEDEDEDEDEDEDEDEDEDEDDEDEDEDEDG46FEDEDEDEDEDEDEDEDEDEDEDEDEDEDDEDEDEDEDEDEDEDEDEDEDEDEDEDEDG
FEDEDEDEDEDEDEDEDEDEDEDEDEDEDDEDEDEDEDG46FEDEDEDEDEDEDEDEDEDEDEDEDEDEDDEDEDEDEDEDEDEDEDEDEDEDEDEDEDG
FEDEDEDEDEDEDEDEDEDEDEDEDEDEDDEDEDEDEDG46FEDEDEDEDEDEDEDEDEDEDEDEDEDEDDEDEDEDEDEDEDEDEDEDEDEDEDEDEDG
FEDEDEDEDEDEDEDEDEDEDEDEDEDEDDEDEDEDEDG46FEDEDEDEDEDEDEDEDEDEDEDEDEDEDDEDEDEDEDEDEDEDEDEDEDEDEDEDEDG
FEDEDEDEDEDEDEDEDEDEDEDEDEDEDDEDEDEDEDG79>CBCBCBCBCBCBCBCBCBCBCBCBCBCBCBCBCBCBCBCBCBCBCBCBCBCBCBCBC@
FEDEDEDEDEDEDEDEDEDEDEDEDEDEDDEDEDEDEDGJJ:::::::::::::::::::::::::::::::::::::::::::::::::::::::::::
FEDEDEDEDEDEDEDEDEDEDEDEDEDEDDEDEDEDEDG:::::::::::::::::::::::::::::::::::::::::::::::::::::::::::::
FEDEDEDEDEDEDEDEDEDEDEDEDEDEDDEDEDEDEDG:::::::::::::::::::::::::::::::::::::::::::::::::::::::::::::
FEDEDEDEDEDEDEDEDEDEDEDEDEDEDDEDEDEDEDG:::::::::::::::::::::::::::::::::::::::::::::::::::::::::::::
FEDEDEDEDEDEDEDEDEDEDEDEDEDEDDEDEDEDEDG:::::::::::::::::::::::::::::::::::::::::::::::::::::::::::::
::::::::::::::::::::::::::::::::::::::::::::::::::::::::::::::::::::::::::::::::::::::::::::::::::::
::::::::::::::::::::::::::::::::::::::::::::::::::::::::::::::::::::::::::::::::::::::::::::::::::::
::::::::::::::::::::::::::::::::::::::::::::::::::::::::::::::::::::::::::::::::::::::::::::::::::::