0000000000000000000000000000000000000000000000000000000000000000000000000000000000000000000000000000
0000000000000000000000000000000000000000000000000000000000000000000000000000000000000000000000000000
0000000000000000000000000000000000000000000000000000000000000000000000000000000000000000000000000000
0000000000000000000000000000000000000000000000000000000000000000000000000000000000000000000000000000
0000000000000000000000000000000000000000000000000000000000000000000000000000000000000000000000000000
0000000000000000000000000000000000000000000000000000000000000000000000000000000000000000000000000000
0000000000000000000000000000000000000000000000000000000000000000000000000000000000000000000000000000
0000000000000000000000000000000000000000000000000000000000000000000000000000000000000000000000000000
0000000000000000000000000000000000000000000000000000000000000000000000000000000000000000000000000000
0000000000000000000000000000000000000000000000000000000000000000000000000000000000000000000000000000
0000000000000000000000000000000000000000000000000000000000000000000000000000000000000000000000000000
0000000000000000000000000000000000000000000000000000000000000000000000000000000000000000000000000000
0000000000000000000000000000000000000000000000000000000000000000000000000000000000000000000000000000
0000000000000000000000000000000000000000000000000000000000000000000000000000000000000000000000000000
0000000000000000000000000000000000000000000000000000000000000000000000000000000000000000000000000000
0000000000000000000000000000000000000000000000000000000000000000000000000000000000000000000000000000
0000000000000000000000000000000000000000000000000000000000000000000000000000000000000000000000000000
0000000000000000000000000000000000000000000000000000000000000000000000000000000000000000000000000000
0000000000000000000000000000000000000000000000000000000000000000000000000000000000000000000000000000
0000000000000000000000000000000000000000000000000000000000000000000000000000000000000000000000000000
0000000000000000000000000000000000000000000000000000000000000000000000000000000000000000000000000000
0000000000000000000000000000000000000000000000000000000000000000000000000000000000000000000000000000
0000000000000000000000000000000000000000000000000000000000000000000000000000000000000000000000000000
0000000000000000000000000000000000000000000000000000000000000000000000000000000000000000000000000000
0000000000000000000000000000000000000000000000000000000000000000000000000000000000000000000000000000
0000000000000000000000000000000000000000000000000000000000000000000000000000000000000000000000000000
0000000000000000000<<<<<<<<<<<<<<<3<<<<<<<<<<<<<<<<<<<<<<<<<<<<<<<<<<<<<<<<<<<0000000000000000000000
000000000000000000000<<<<<<<<<<<<<<<<<<<<<<<<<<<<<<<<<<<<<<<<<<<<<<<<<<<<<<<000000000000000000000000
00000000000000000000000<<<<<<<<<<<<<<<<<<<<<<<<<<<<<<<<<<<3<<<<<<<<<<<<<<<00000000000000000000000000
0000000000000000000000000<<<<<<<<<<<<3<<<<<<<<<<<<<<<<<<<<<<<<<<<<<<<<<<0000000000000000000000000000
000000000000000000000000000::::::::::::::::::::::b::::::::::::::::::::000000000000000000000000000000
00000000000000000000000000000:::::::::::::::::::::::::::::::::::::::00000000000000000000000000000000
0000000000000000000000000000000:::::::::::::1222223::::::::::::::::000000000000000000000000000000000
000000000000000000000000000000000:::::::::::6555556::::::::::::::00000000000000000000000000000000000
00000000000000000000000000000000000::::::::::6555556:::::::::::0000000000000000000000000000000000000
0000000000000000000000000000000000000:::::::::6555556::::::::000000000000000000000000000000000000000
00000000000000000000000000000000000000:::::::6555556:::::::00000000000000000000000000000000000000000
0000000000000000000000000000000000000000:::::6555556::::::::0000000000000000000000000000000000000000
00000000000000000000000000000000000000000::::6555556::::::::0000000000000000000000000000000000000000
0000000000000000000000000000000000000000000::6555556:::::::00000000000000000000000000000000000000000
00000000000000000000000000000000000000000::::6555556:::::::00000000000000000000000000000000000000000
0000000000000000000000000000000000000000:::::6555556:::::::00000000000000000000000000000000000000000
000000000000000000000000000000000000000::::::6555556:::::::00000000000000000000000000000000000000000
00000000000000000000000000000000000000:::::::6555556:::::::00000000000000000000000000000000000000000
0000000000000000000000000000000000000000::::::655555556:::::::00000000000000000000000000000000000000
0000000000000000000000000000000000000000000::::::6555556:::::::0000000000000000000000000000000000000
0000000000000000000000000000000000000000:::::::::655556::::::000000000000000000000000000000000000000
0000000000000000000000000000000000000000::::::::6555556:::::::00000000000000000000000000000000000000
00000000000000000000000000000000000000000:::::::6555556::::::000000000000000000000000000000000000000
000000000000000000000000000000000000000000::::::6555556:::::::00000000000000000000000000000000000000
00000000000000000000000000000000000000000:::::::6555556:::::::00000000000000000000000000000000000000
0000000000000000000000000000000000000000:::::::6555556:::::::000000000000000000000000000000000000000
000000000000000000000000000000000000000:::::::6555556:::::::0000000000000000000000000000000000000000
000000000000000000000000000000000000000:::::::6555556:::::::0000000000000000000000000000000000000000
000000000000000000000000000000000000000:::::::6555d56:::::::0000000000000000000000000000000000000000
000000000000000000000000000000000000000:::::::6555556:::::::::00000000000000000000000000000000000000
0000000000000000000000000000000000000000:::::::65555556:::::::00000000000000000000000000000000000000
000000000000000000000000000000000000000:::::::65555556::::::0000000000000000000000000000000000000000
000000000000000000000000000000000000000000:::::::65555556:::::::000000000000000000000000000000000000
000000000000000000000000000000000000000000000:::::::65555556:::::00000000000000000000000000000000000
00000000000000000000000000000000000000000000000000:::::::6555556:::::::::000000000000000000000000000
000000000000000000000000000000000000000000000000000000::::::65555556:::::::::00000000000000000000000
00000000000000000000000000000000000000000000000000000000:::::::65555556::::::::000000000000000000000
00000000000000000000000000000000000000000000000000000000000:::::::655556::::::::00000000000000000000
00000000000000000000000000000000000000000000000000000000000000000:::65556::::::::0000000000000000000
00000000000000000000000000000000000000000000000::::3222221::::00000:655556::::::::000000000000000000
00000000000000000000000000000000000000000000::::::655555556::::000::::655556:::::0000000000000000000
00000000000000000000000000000000000000000000::::::655555556:::::0:::655556::::::00000000000000000000
000000000000000000000000000000000000000000::::::6555600655556::000::655556:::::::0000000000000000000
000000000000000000000000000000000000000::::::655556::0::655556:00000:655556:::::00000000000000000000
00000000000000000000000000000000000000::::::655556::00::655556:0000::655d56::::000000000000000000000
0000000000000000000000000000000000000::::::655556:::000:655550:::00:655556:::::000000000000000000000
0000000000000000000000000000000000000::::::655556:::0000:::655556:0:655556::::0000000000000000000000
000000000000000000000000000000000000::::::655556:::::00000000555560655556:::::0000000000000000000000
0000000000000000000000000000000000000::::::655556:::::::0:::::65555555556:::::::00000000000000000000
00000000000000000000000000000000000000::::::655556:::::000:::::655555556:::::::000000000000000000000
0000000000000000000000000000000000000::::::655556::::::00000::::7888889:::::000000000000000000000000
00000000000000000000000000000000000::::::655556:::::::0000000000::::::::::00000000000000000000000000
0000000000000000000000000000000000::::::655556:::::::0000000000000::::000000000000000000000000000000
000000000000000000000000000000000::::::655556:::::::000000000000000::0000000000000000000000000000000
00000000000000000000000000000000::::::655556:::::::0000000000000000000000000000000000000000000000000
0000000000000000000000000000000::::::655556:::::::00000000000000000000000000000000000000000000000000
000000000000000000000000000000::::::655556:::::::000000000000000000000000000000000000000000000000000
0000000000000000000000000000000::::::655556:::::::00000000000000000000000000000000000000000000000000
000000000000000000000::::::::::::::::65P56:::::::::::::::::00000000000000000000000000000000000000000
00000000000000000000:::::::::::::::::788889:::::::::::::::::0000000000000000000000000000000000000000
0000000000000000000::::::::::::::::::::::::::::::::::::::::::000000000000000000000000000000000000000
000000000000000000::::::::::::::::::::::::::::::::::::::::::::00000000000000000000000000000000000000
0000000000000000000000000000000000000000000000000000000000000000000000000000000000000000000000000000
0000000000000000000000000000000000000000000000000000000000000000000000000000000000000000000000000000
0000000000000000000000000000000000000000000000000000000000000000000000000000000000000000000000000000
0000000000000000000000000000000000000000000000000000000000000000000000000000000000000000000000000000
0000000000000000000000000000000000000000000000000000000000000000000000000000000000000000000000000000
0000000000000000000000000000000000000000000000000000000000000000000000000000000000000000000000000000
0000000000000000000000000000000000000000000000000000000000000000000000000000000000000000000000000000
0000000000000000000000000000000000000000000000000000000000000000000000000000000000000000000000000000
0000000000000000000000000000000000000000000000000000000000000000000000000000000000000000000000000000
0000000000000000000000000000000000000000000000000000000000000000000000000000000000000000000000000000
0000000000000000000000000000000000000000000000000000000000000000000000000000000000000000000000000000
0000000000000000000000000000000000000000000000000000000000000000000000000000000000000000000000000000
