0000000000000000000000000000000000000000000000000000000000000000000000000000000000000000000000000000
0000000000000000000000000000000000000000000000000000000000000000000000000000000000000000000000000000
0000000000000000000000000000000000000000000000000000000000000000000000:::::0000000000000000000000000
000000000000000000000000000000000000000000000000000000000000000000:::::::::::::000000000000000000000
000000000000000000000000000000000000000000000000000000000000000000:::::::::::::::0000000000000000000
000000000000000000000000000000000000000000000000000000000000000::::::::::::::::::::00000000000000000
00000000000000000000000000000000000000000000000000000000000000000:::::55555bf5555:::::00000000000000
00000000000000000000000000000000000000000000000000000000000000:::::555:::::0000000000000000000000000
0000000000000000000000000000000000000000000000000000000000000:::::555:::::00000000000000000000000000
0000000000000000000000000000000000000000000000000000000000000:::::555:::::00000000000000000000000000
0000000000000000000000000000000000000000000000000000000000000:::::555:::::00000000000000000000000000
000000000000000000000000000000000000000000000000000000000000:::::555:::::000000000000000000000000000
00000000000000000000000000000000000000000000000000000000000:::::555:::::0000000000000000000000000000
0000000000000000000000000000000000000000000000000000000000:::::555:::::00000000000000000000000000000
0000000000000000000000000000000000000000000000000000000000:::::555:::::00000000000000000000000000000
00000000000000000000000000000000000000000000000000000000000:::::555:::::0000000000000000000000000000
000000000000000000000000000000000000000000000000000000000000:::::555:::::000000000000000000000000000
00000000000000000000000000000000000000000000000000000000::::::::::555:::::00000000000000000000000000
0000000000000000000000000000000000000000000000000000:::::::::::::::555:::::0000000000000000000000000
00000000000000000000000000000000000000000000:::::::::::::::b:::::555:::::000000000000000000000000000
0000000000000000000000000000000000000000000000:::::5555555555555555555:::::0000000000000000000000000
000000000000000000000000000000000000000000000:::::55555:::::::::::::::::::::000000000000000000000000
0000000000000000000000000000000000000000000:::::5555555::::::::::::::0000000000000000000000000000000
000000000000000000000000000000000000000000:::::5555555::::::::::::0000000000000000000000000000000000
000000000000000000000000000000000000000000:::::5555555:::::::::0000000000000000000000000000000000000
000000000000000000000000000000000000000000:::::5555555:::::00000000000000000000000000000000000000000
000000000000000000000000000000000000000000:::::5555:::::00000000000000000000000000000000000000000000
000000000000000000000000000000000000000:::::5555555:::::00000000000000000000000000000000000000000000
0000000000000000000000000000000000000:::::5555:::::0000000000000000000000000000000000000000000000000
000000000000000000000000000000000000:::::5555:::::00000000000000000000000000000000000000000000000000
000000000000000000000000000000000000:::::5555:::::00000000000000000000000000000000000000000000000000
000000000000000000000000000000000000:::::5555:::::00000000000000000000000000000000000000000000000000
00000000000000000000000000000000000:::::5555:::::000000000000000000000000000000000000000000000000000
000000000000000000000000000000000000:::::5555:::::00000000000000000000000000000000000000000000000000
0000000000000000000000000000000000:::::5555:::::::::000000000000000000000000000000000000000000000000
0000000000000000000000000000000000:::::5555::::::::::::::0000000000000000000000000000000000000000000
00000000000000000000000000000000:::::5555:::::::::::::::::::0000000000000000000000000000000000000000
00000000000000000000000000000000:::::5555::::::::::g:::::::::::::::000000000000000000000000000000000
00000000000000000000000000000000000:::::55555555555555555555:::::00000000000000000000000000000000000
00000000000000000000000000000000000:::::55555555555555555555:::::00000000000000000000000000000000000
00000000000000000000000000000000000000000::::::::::::55555:::::0000000000000000000000000000000000000
00000000000000000000000000000000000000000000000:::::55555:::::00000000000000000000000000000000000000
0000000000000000000000000000000000000000000000:::::55555:::::000000000000000000000000000000000000000
000000000000000000000000000000000000000000000:::::55555:::::0000000000000000000000000000000000000000
00000000000000000000000000000000000000000000:::::55555:::::::000000000000000000000000000000000000000
00000000000000000000000000000000000000000000:::::5555:::::000000000000000000000000000000000000000000
000000000000000000000000000000000000000000000:::::5555:::::00000000000000000000000000000000000000000
0000000000000000000000000000000000000000000000:::::5555:::::0000000000000000000000000000000000000000
00000000000000000000000000000000000000000000000:::::5555:::::000000000000000000000000000000000000000
000000000000000000000000000000000000000000000000:::::55555:::::0000000000000000000000000000000000000
0000000000000000000000000000000000000000000000000:::::5555:::::0000000000000000000000000000000000000
00000000000000000000000000000000000000000000000000:::::55b5:::::000000000000000000000000000000000000
0000000000000000000000000000000000000000000000<<<<<<<<<555<<<<<<<00000000000000000000000000000000000
0000000000000000000000000000000000000000000000<<<<<<<<<555<<<<<<<00000000000000000000000000009000000
00000000000000000000000000000000000000000000000<<<<<<<<555<<<<<<<<0000000000000000000000000000000000
00000000000000000000000000000000000000000000000<<<<<<<<<<<<<<<<<<<0000000000000000000000000000000000
000000000000000000000000000000000000000000000000<<<<<<<<<<<<<<<<<<<000000000000000000000000000000000
0000000000000000000000000000000000000000000000000<<<<<<<<<5<<<<<<<<<00000000000000000000000000000000
0000000000000000000000000000000000000000000000000<<<<5<<<<<<<<<<<<<<00000000000000000000000000000000
0000000000000000000000000000000000000000000000000<<<<<<<<<5<<<<<<<<<00000000000000000000000000000000
0000000000000000000000000000000000000000000000000<<<<<<<<<<<<<<5<<<<00000000000000000000000000000000
0000000000000000000000000000000000000000<<<<<<<<<<<<<<<<<<<<<<<<<<<<<<<00000000000000000000000000000
00000000000000000000000000000000<<<<<d<<<<<<<<<<<<<<5<<<<<<5<<<<<<<<<<<<<<<0000000000000000000000000
00000000000000000000000000000000<<<<<<<<<<<<<<<<<<<<<<<<<<<<<<<<<<<<<<<<<<<0000000000000000000000000
00000000000000000000000000000000<<<<<<<<<<<<<<d<<<<<<<<<<<<<<<<<<<<<<<<<<<<0000000000000000000000000
00000000000000000000000000000000<<<<<<<<<<<<<<<<<<<<<<<<<<<<<<<<<<<<<<<<<<<0000000000000000000000000
0000000000000000000000000000<<<<<<<<<<<<<<<<<<<<<<<<<<5<<<<<<<<<<d<<<<<<<<<<000000000000000000000000
0000000000000000000000<<d<<<<<<<<<<<<<<<<<<d<<<<<<<<<<<<<<<<<<<<<<<<<<<<<<<<<<<<<0000000000000000000
0000000000000000000000000<<<<<<<<<<<<<<<<<<<<<<<<<<<<<<<<<<<<<<<<<<<<<<<<<<<<<<<<<<<0000000000000000
00000000000000000000<<<<<<<<<<<<<<<<<<<<<<<<<<<<<<<<<<<<<<<<<<<<<<<<<d<<<<<<<<<000000000000000000000
00000000000000<<<<<<<<<<<<<<<<<<<<d<<<<<<<<<<<<<<<<<<<<<<<d<<<<<<<<<<<<<<000000000000000000000000000
000000000000000000<<<<<<<<<<<<<<<<<<<<<<<<<<<d<<<<<<<<<<<<<<<<<<<<<<<<<<<<<<<<0000000000000000000000
000000000000000000<<<<<d<<<<<<<<<<<<<<<<<<<<<<<<<<<<<<<<<<<d<<<<<<<<<<<<<<<<<00000000000000000000000
000000000000000000<<<<<<<<<<<<<<<<<<<<<<<<<<<<<<<<<<<<<<<<<<<<<<<<<<<<<<<<<<<00000000000000000000000
000000000000000000000<<<<<<<<<<<<<<<d<<<<<<<<<<<<<<<<<<<<<<<<<<<<<<<<<<<<<<<<<<<00000000000000000000
000000000000000000<<<<<<<<<<<<<<<<<<<<<<<<<<<<<<<<<<<<<<<<<<<<<d<<<<<<<<<<<<<00000000000000000000000
000000000000000000<<<<<<<<<<<<<<<<<<<<<<<<<<<<<<<<<<<<<<<<<<<<<<<<<<<<<<<<<<<00000000000000000000000
0000000000000000000<<<<<<<<<<<<<<<<<<<<<<<<<<<<<<<<<<<<<<<<<<<<<<<<<<<<<<<<<<<0000000000000000000000
0000000000000000000<<<<<<<<<<<<<<<<<<<<<<<<<<<<<d<<<<<<<<<<<<<<<<<<<<<d<<<<<<<0000000000000000000000
0000000000000000000<<<<<<<<<<<<<<<d<<<<<<<<<<<<<<<<<<<<<<<<<<<<<<<<<<<<<<<<<<<0000000000000000000000
0000000000000000000<<<<<<<<<<<<<<<<<<<<<<<<<<<<<<<<<<<<<<<<<<<<<<<d<<<<<<<<<<<0000000000000000000000
0000000000000000000<<<<<<<<<<<<<<<<<<<<<<<<<<<P<<<<<<<<<<<<<<<<<<<<<<<<<<<<<<<0000000000000000000000
000000000000000000000<<<<<<<<<<<<<<<<<<<<<<<<<<<<<<<<d<<<<<<<<<<<<<<<<<<<<<<000000000000000000000000
00000000000000000000000<<<<<<<<<<<<<<<<<<<<<<<<<<<<<<<<<<<<<<<<<<<<<<<<<<<00000000000000000000000000
0000000000000000000000000<<<<<<<<<<<<<<<<<<<<<<<<<<<<<<<<<<<<<<<<<<<<<<<0000000000000000000000000000
0000000000000000000000000000000000000000000000000000000000000000000000000000000000000000000000000000
0000000000000000000000000000000000000000000000000000000000000000000000000000000000000000000000000000
0000000000000000000000000000000000000000000000000000000000000000000000000000000000000000000000000000
0000000000000000000000000000000000000000000000000000000000000000000000000000000000000000000000000000
0000000000000000000000000000000000000000000000000000000000000000000000000000000000000000000000000000
0000000000000000000000000000000000000000000000000000000000000000000000000000000000000000000000000000
0000000000000000000000000000000000000000000000000000000000000000000000000000000000000000000000000000
0000000000000000000000000000000000000000000000000000000000000000000000000000000000000000000000000000
0000000000000000000000000000000000000000000000000000000000000000000000000000000000000000000000000000
0000000000000000000000000000000000000000000000000000000000000000000000000000000000000000000000000000
0000000000000000000000000000000000000000000000000000000000000000000000000000000000000000000000000000
0000000000000000000000000000000000000000000000000000000000000000000000000000000000000000000000000000
0000000000000000000000000000000000000000000000000000000000000000000000000000000000000000000000000000
0000000000000000000000000000000000000000000000000000000000000000000000000000000000000000000000000000
0000000000000000000000000000000000000000000000000000000000000000000000000000000000000000000000000000