JJJJJJJJJJJJJJJJJJJJJJJJJJJJJJJJJJJJJJJJJJJJJJJJJJJJJJJJJJJJJJJJJJJJJJJJJJJJJJJJJJJJJJJJJJJJJJJJJJJJ
JJJJJJJJJJJJJJJJJJJJJJJJJJJJJJJJJJJJJJJJJJJJJJJJJJJJJJJJJJJJJJJJJJJJJJJJJJJJJJJJJJJJJJJJJJJJJJJJJJJJ
JJJJJJJJJJJJJJJJJJJJJJJJJJJJJJJJJJJJJJJJJJJJJJJJJJJJJJJJJJJJJJJJJJJJJJ:::::JJJJJJJJJJJJJJJJJJJJJJJJJ
JJJJJJJJJJJJJJJJJJJJJJJJJJJJJJJJJJJJJJJJJJJJJJJJJJJJJJJJJJJJJJJJJJ:::::::::::::JJJJJJJJJJJJJJJJJJJJJ
JJJJJJJJJJJJJJJJJJJJJJJJJJJJJJJJJJJJJJJJJJJJJJJJJJJJJJJJJJJJJJJJJJ::1222222222223:::::JJJJJJJJJJJJJJ
JJJJJJJJJJJJJJJJJJJJJJJJJJJJJJJJJJJJJJJJJJJJJJJJJJJJJJJJJJJJJJJ::::15555555555556::JJJJJJJJJJJJJJJJJ
JJJJJJJJJJJJJJJJJJJJJJJJJJJJJJJJJJJJJJJJJJJJJJJJJJJJJJJJJJJJJJJJJ:155555555bf5589:::::JJJJJJJJJJJJJJ
JJJJJJJJJJJJJJJJJJJJJJJJJJJJJJJJJJJJJJJJJJJJJJJJJJJJJJJJJJJJJJ:::15555555888889::::JJJJJJJJJJJJJJJJJ
JJJJJJJJJJJJJJJJJJJJJJJJJJJJJJJJJJJJJJJJJJJJJJJJJJJJJJJJJJJJJ::::45555559::::::::JJJJJJJJJJJJJJJJJJJ
JJJJJJJJJJJJJJJJJJJJJJJJJJJJJJJJJJJJJJJJJJJJJJJJJJJJJJJJJJJJJ::::4555559::::::JJJJJJJJJJJJJJJJJJJJJJ
JJJJJJJJJJJJJJJJJJJJJJJJJJJJJJJJJJJJJJJJJJJJJJJJJJJJJJJJJJJJJ::::455589:::::JJJJJJJJJJJJJJJJJJJJJJJJ
JJJJJJJJJJJJJJJJJJJJJJJJJJJJJJJJJJJJJJJJJJJJJJJJJJJJJJJJJJJJ::::15589::::JJJJJJJJJJJJJJJJJJJJJJJJJJJ
JJJJJJJJJJJJJJJJJJJJJJJJJJJJJJJJJJJJJJJJJJJJJJJJJJJJJJJJJJJ:::12556:::::JJJJJJJJJJJJJJJJJJJJJJJJJJJJ
JJJJJJJJJJJJJJJJJJJJJJJJJJJJJJJJJJJJJJJJJJJJJJJJJJJJJJJJJJ::::45556::::JJJJJJJJJJJJJJJJJJJJJJJJJJJJJ
JJJJJJJJJJJJJJJJJJJJJJJJJJJJJJJJJJJJJJJJJJJJJJJJJJJJJJJJJJ::::45556::::JJJJJJJJJJJJJJJJJJJJJJJJJJJJJ
JJJJJJJJJJJJJJJJJJJJJJJJJJJJJJJJJJJJJJJJJJJJJJJJJJJJJJJJJJJ:::45556:::::JJJJJJJJJJJJJJJJJJJJJJJJJJJJ
JJJJJJJJJJJJJJJJJJJJJJJJJJJJJJJJJJJJJJJJJJJJJJJJJJJJJJJJJJ::::455553:::::JJJJJJJJJJJJJJJJJJJJJJJJJJJ
JJJJJJJJJJJJJJJJJJJJJJJJJJJJJJJJJJJJJJJJJJJJJJJJJJJJJJJJ:::1225555553:::::JJJJJJJJJJJJJJJJJJJJJJJJJJ
JJJJJJJJJJJJJJJJJJJJJJJJJJJJJJJJJJJJJJJJJJJ:::::g:::::122225555555559:::::JJJJJJJJJJJJJJJJJJJJJJJJJ0
JJJJJJJJJJJJJJJJJJJJJJJJJJJJJJJJJJJJJJJJJJJJ:::::::12255555555555589:::::JJJJJJJJJJJJJJJJJJJJJJJJJJJ
JJJJJJJJJJJJJJJJJJJJJJJJJJJJJJJJJJJJJJJJJJJJJJ::::1555555555555589:::::::::JJJJJJJJJJJJJJJJJJJJJJJJJ
JJJJJJJJJJJJJJJJJJJJJJJJJJJJJJJJJJJJJJJJJJJJJ::::155555888888889:::::::::JJJJJJJJJJJJJJJJJJJJJJJJJJJ
JJJJJJJJJJJJJJJJJJJJJJJJJJJJJJJJJJJJJJJJJJJ::::12555556::::::::::::::JJJJJJJJJJJJJJJJJJJJJJJJJJJJJJJ
JJJJJJJJJJJJJJJJJJJJJJJJJJJJJJJJJJJJJJJJJJ::::155555556:::::::::::JJJJJJJJJJJJJJJJJJJJJJJJJJJJJJJJJJ
JJJJJJJJJJJJJJJJJJJJJJJJJJJJJJJJJJJJJJJJJJ::::455555556::::::::JJJJJJJJJJJJJJJJJJJJJJJJJJJJJJJJJJJJJ
JJJJJJJJJJJJJJJJJJJJJJJJJJJJJJJJJJJJJJJJJJ::::455558889::::JJJJJJJJJJJJJJJJJJJJJJJJJJJJJJJJJJJJJJJJJ
JJJJJJJJJJJJJJJJJJJJJJJJJJJJJJJJJJ::::::::::1255556:::::JJJJJJJJJJJJJJJJJJJJJJJJJJJJJJJJJJJJJJJJJJJJ
JJJJJJJJJJJJJJJJJJJJJJJJJJJJJJJJJJJJJJJ::1225558889:::::JJJJJJJJJJJJJJJJJJJJJJJJJJJJJJJJJJJJJJJJJJJJ
JJJJJJJJJJJJJJJJJJJJJJJJJJJJJJJJJJJJJ::::455559::::::JJJJJJJJJJJJJJJJJJJJJJJJJJJJJJJJJJJJJJJJJJJJJJJ
JJJJJJJJJJJJJJJJJJJJJJJJJJJJJJJJJJJJ::::155559::::::JJJJJJJJJJJJJJJJJJJJJJJJJJJJJJJJJJJJJJJJJJJJJJJJ
JJJJJJJJJJJJJJJJJJJJJJJJJJJJJJJJJJJJ::::45556::::::JJJJJJJJJJJJJJJJJJJJJJJJJJJJJJJJJJJJJJJJJJJJJJJJJ
JJJJJJJJJJJJJJJJJJJJJJJJJJJJJJJJJJJJ::::45b56:::::JJJJJJJJJJJJJJJJJJJJJJJJJJJJJJJJJJJJJJJJJJJJJJJJJJ
JJJJJJJJJJJJJJJJJJJJJJJJJJJJJJJJJJJ::::155556::::JJJJJJJJJJJJJJJJJJJJJJJJJJJJJJJJJJJJJJJJJJJJJJJJJJJ
JJJJJJJJJJJJJJJJJJJJJJJJJJJJJJJJJJJJ:::455556:::::JJJJJJJJJJJJJJJJJJJJJJJJJJJJJJJJJJJJJJJJJJJJJJJJJJ
JJJJJJJJJJJJJJJJJJJJJJJJJJJJJJJJJJ::::15555553::::::::JJJJJJJJJJJJJJJJJJJJJJJJJJJJJJJJJJJJJJJJJJJJJJ
JJJJJJJJJJJJJJJJJJJJJJJJJJJJJJJJJJ:::155555556:::::::::::::JJJJJJJJJJJJJJJJJJJJJJJJJJJJJJJJJJJJJJJJJ
JJJJJJJJJJJJJJJJJJJJJJJJJJJJJJJJ:::::4555555553:::::::::::::::JJJJJJJJJJJJJJJJJJJJJJJJJJJJJJJJJJJJJJ
JJJJJJJJJJJJJJJJJJJJJJJJJJJJJJJJ:::::45555555553:::::::::::::::::::JJJJJJJJJJJJJJJJJJJJJJJJJJJJJJJJJ
JJJJJJJJJJJJJJJJJJJJJJJJJJJJJJJJJJJ::7855555555523:::::::::::::::JJJJJJJJJJJJJJJJJJJJJJJJJJJJJJJJJJJ
JJJJJJJJJJJJJJJJJJJJJJJJJJJJJJJJJJJ::::7555555555522223::::::::::JJJJJJJJJJJJJJJJJJJJJJJJJJJJJJJJJJJ
JJJJJJJJJJJJJJJJJJJJJJJJJJJJJJJJJJJJJJJ:7888855555555553:::::::JJJJJJJJJJJJJJJJJJJJJJJJJJJJJJJJJJJJJ
JJJJJJJJJJJJJJJJJJJJJJJJJJJJJJJJJJJJJJJ::::::788555555553:::::JJJJJJJJJJJJJJJJJJJJJJJJJJJJJJJJJJJJJJ
JJJJJJJJJJJJJJJJJJJJJJJJJJJJJJJJJJJJJJJJJJJJJ:::755555559::::JJJJJJJJJJJJJJJJJJJJJJJJJJJJJJJJJJJJJJJ
JJJJJJJJJJJJJJJJJJJJJJJJJJJJJJJJJJJJJJJJJJJJJJ:::4555559::::JJJJJJJJJJJJJJJJJJJJJJJJJJJJJJJJJJJJJJJJ
JJJJJJJJJJJJJJJJJJJJJJJJJJJJJJJJJJJJJJJJJJJJ::::1555559::::::JJJJJJJJJJJJJJJJJJJJJJJJJJJJJJJJJJJJJJJ
JJJJJJJJJJJJJJJJJJJJJJJJJJJJJJJJJJJJJJJJJJJJ::::755556::::JJJJJJJJJJJJJJJJJJJJJJJJJJJJJJJJJJJJJJJJJJ
JJJJJJJJJJJJJJJJJJJJJJJJJJJJJJJJJJJJJJJJJJJJJ::::755553:::::JJJJJJJJJJJJJJJJJJJJJJJJJJJJJJJJJJJJJJJJ
JJJJJJJJJJJJJJJJJJJJJJJJJJJJJJJJJJJJJJJJJJJJJJ::::755553:::::JJJJJJJJJJJJJJJJJJJJJJJJJJJJJJJJJJJJJJJ
JJJJJJJJJJJJJJJJJJJJJJJJJJJJJJJJJJJJJJJJJJJJJJJ::::7555523::::JJJJJJJJJJJJJJJJJJJJJJJJJJJJJJJJJJJJJJ
JJJJJJJJJJJJJJJJJJJJJJJJJJJJJJJJJJJJJJJJJJJJJJJJ::::755556:::::JJJJJJJJJJJJJJJJJJJJJJJJJJJJJJJJJJJJJ
JJJJJJJJJJJJJJJJJJJJJJJJJJJJJJJJJJJJJJJJJJJJJJJJJ::::75556::::::JJJJJJJJJJJJJJJJJJJJJJJJJJJJJJJJJJJJ
JJJJJJJJJJJJJJJJJJJJJJJJJJJJJJJJJJJJJJJJJJJJJJJJJJ::::455b3::::::JJJJJJJJJJJJJJJJJJJJJJJJJJJJJJJJJJJ
dTTTTTTTTTTTTTTTTTTTTTTTTTTTTTTTTTTTTTTTTTTTTT<<<<<<<<45556<<<<<<<TTTTTTTTTTTTTTTTTTTTTTTTTTTTTTTTTd
dTTTTTTTTTTTTTTTTTTTTTTTTTTTTTTTTTTTTTTTTTTTTT<U<<<<<<45556<<U<<<<TTTTTTTTTTTTTTTTTTTTTTTTTTT9TTTTTd
dTTTTTTTTTTTTTTTTTTTTTTTTTTTTTTTTTTTTTTTTTTTTTT<<<<<<<78889<<<<<<<TTTTTTTTTTTTTTTTTTTTTTTTTTTTTTTTTd
dTTTTTTTTTTTTTTTTTTTTTTTTTTTTTTTTTTTTTTTTTTTTTT<<<<<<<<KLLM<<<<<<<<TTTTTTTTTTTTTTTTTTTTTTTTTTTTTTTTd
dTTTTTTTTTTTTTTTTTTTTTTTTTTTTTTTTTTTTTTTTTTTTTTT<<<<<<<QOOP<<<<<<<<<TTTTTTTTTTTTTTTTTTTTTTTTTTTTTTTd
dTTTTTTTTTTTTTTTTTTTTTTTTTTTTTTTTTTTTTTTTTTTTTTTTT<<<<<<NOOM<<<<<<<<<TTTTTTTTTTTTTTTTTTTTTTTTTTTTTTd
dTTTTTTTTTTTTTTTTTTTTTTTTTTTTTTTTTTTTTTTTTTTTTTTT<<<<<<<NOOP<<U<<<<<<TTTTTTTTTTTTTTTTTTTTTTTTTTTTTTd
dTTTTTTTTTTTTTTTTTTTTTTTTTTTTTTTTTTTTTTTTTTTTTTTT<<<<<<<NOOP<<<<<<<<<TTTTTTTTTTTTTTTTTTTTTTTTTTTTTTd
dTTTTTTTTTTTTTTTTTTTTTTTTTTTTTTTTTTTTTTTTTTTTTTTT<<<<<<<NOOP<<<<<<<<<TTTTTTTTTTTTTTTTTTTTTTTTTTTTTTd
dTTTTTTTTTTTTTTTTTTTTTTTTTTTTTTTTTTTTTTT<<<<<<<<<<<<<<<<NOOP<<<<<<<<<<<TTTTTTTTTTTTTTTTTTTTTTTTTTTTd
dTTTTTTTTTTTTTTTTTTTTTTTTTTTTTTT<<<<<d<<<<<<<<<<<<U<<<<<QRRS<<<<<<<<<<<<<<<<TTTTTTTTTTTTTTTTTTTTTTTd
dddddddddddddddddddddddddddddddddddddddddddddddddddddddddddddddddddddddddddddddddddddddddddddddddddd
dTTTTTTTTTTTTTTTTTTTTTTTTTTTTTTT<<<<<<<<<<<<<<d<<<<<<<<<<<<<<<<<<<<<<<<<<<<<TTTTTTTTTTTTTTTTTTTTTTTd
dTTTTTTTTTTTTTTTTTTTTTTTTTTTTTTT<U<<<<<<<<<<<<<<<<<<<<<<<<<<<<<<<<<<<<<<<<<<TTTTTTTTTTTTTTTTTTTTTTTd
dTTTTTTTTTTTTTTTTTTTTTTTTTTT<<<<<<<<<<<<U<<<<<<<<<<<<<<<<<<<<<<<<U<<<<<<<<<<<TTTTTTTTTTTTTTTTTTTTTTd
dTTTTTTTTTTTTTTTTTTTTT<<d<<<<<<<<<<<<<<<<<<<<<<<<<<<U<<<<<<<<<<<<<<<<<<<<<<<<<<<<<TTTTTTTTTTTTTTTTTd
dTTTTTTTTTTTTTTTTTTTTTTTT<<<<<<<<<U<<<<<<<<<<<<<<<<<<<<<<<<<<<<<<<<<<<<<<<<U<<<<<<<<<TTTTTTTTTTTTTTd
dTTTTTTTTTTTTTTTTTTT<<<<<<<KM<<<<<<<<<<<<<<<<<<<<<<<<<<<<<<<<<<<<<<<<d<<<<<<<<<<TTTTTTTTTTTTTTTTTTTd
dTTTTTTTTTTTTT<<<<<<<<<<<<<QS<<<<<d<<<<<<<<<<<<<<<<<<<<<<<d<<<<<<<<<<<<<<TTTTTTTTTTTTTTTTTTTTTTTTTTd
dTTTTTTTTTTTTTTTTT<<<<<<<<<<<<<<<<<<<<<<<<<<<U<<<<<<<<<<<<<<<<<<<<<<<<<<<<TTTTTTTTTTTTTTTTTTTTTTTTTd
dTTTTTTTTTTTTTTTTT<<<<<d<<<<<<<<<<<<<<<<<<<<<<<<<<<<<<<<<<<U<<<<<<<<<<d<<<<<<<TTTTTTTTTTTTTTTTTTTTTd
dTTTTTTTTTTTTTTTTT<<<<<<<<<<<<<<<<<<<<<<<<<<<<<<<<<<<<<<<<<<<<<<<<<<<<<<<<<<<<TTTTTTTTTTTTTTTTTTTTTd
dTTTTTTTTTTTTTTTTTTTT<<<<<<<<<<<<<<<d<<<<<<<<<<<<<<<<<<<<<<<<<<<<<<<<<<<<<<<U<<<<TTTTTTTTTTTTTTTTTTd
dTTTTTTTTTTTT<<<<<<<<<<<<<<<<<<<<<<<<<<<<<KM<<<<<<<<<<<<d<<<<<<d<<<<<<<<<<<<<<<<<<<<TTTTTTTTTTTTTTTd
dTTTTTTTTTTT<<<<<<U<<<<<<<<<<<<<<<<<<<<<<<QS<<<<<<<<<<<<<<<<<<<<<<<<<<<<<KM<<<<<<<<<<TTTTTTTTTTTTTTd
dTTTTTTTTTT<<<<<<<TT<<<<<<<<U<<<<<<<<<<<<<<<<<<<<<<<<<<<<<<<<<<<<<<<<<<<<QS<<<<<<<<<<<TTTTTTTTTTTTTd
dTTTTTTTTT<<<<<<<<TT<<<<<<<<<<<<<<<<U<<<<<<<<<<<d<<<<<<<<<<<<<<<<<<<<<d<<<<<<<<<<<<<<<<TTTTTTTTTTTTd
dTTTTTTTT<<<<<<<<<<<<<<<<<<<<<<<<<d<<<<<<<<<<<<<<<<<<<<U<<<<<<<<<<<<<<<<<<<<<<<<<<U<<<<<TTTTTTTTTTTd
dTTTTTTT<<<<U<<<<<<<<<<<<<<<<<<<<<<<<<<<<<<<<<<<<<<<<<<<<<<<<<<<<<U<<<<<<<<<<<<<<<<<<<<<<TTTTTTTTTTd
dTTTTTT<<<<<<<<<<<<<<<<<<<<<<<<<<<<<<<<<<<<<<<*<<<<<<<<<<<<<<<<<<<<<<<<<<<<<<<<<<<<<<<<<<<TTTTTTTTTd
d<<<<<<<<<<<<<<<<<<<<<<U<<<<<<<<<<<<<<<<d<<<<<<<<<<<<<<KM<<<<<<<<<<<<<<<<<<<d<<<<<<<<<<<<<<<<<<<<<<d
d<<<<<<<U<<<<<<<<<<<<<<<<<<<<<<d<<<<<<<<<<<<<<<<<<<<<<<QS<<<<<<<<<<<<<<<<<<<<<<<<<<<<<<<<<<U<<<<<<<d
d<<<<<<<<<<<<<<<<<<<<<<<<<<<<<<<<<<<<<<<<<<<<<<<<<<<<<<<<<<<<<<<<<<<<<<<<<<<<<<<<<<<<<<<<<<<<<<<<<<d
=AAAAAAAAAAAAAAAAAAAAAAAAAAAAAAAAAAAAAAAAA?0000000:000000=AAAAAAAAAAAAAAAAAAAAAAAAAAAAAAAAAAAAAAAAA?
FEDEDEDEDEDEDEDEDEDEDEDEDEDEDDEDEDEDEDEDEDG::::0::::0::::FEDEDEDEDEDEDEDEDEDEDEDEDEDEDDEDEDEDEDEDEDG
FEDEDEDEDEDEDEDEDEDEDEDEDEDEDDEDEDEDEDEDEDG::::122223::J:FEDEDEDEDEDEDEDEDEDEDEDEDEDEDDEDEDEDEDEDEDG
FEDEDEDEDEDEDEDEDEDEDEDEDEDEDDEDEDEDEDEDEDG::::455556::::FEDEDEDEDEDEDEDEDEDEDEDEDEDEDDEDEDEDEDEDEDG
FEDEDEDEDEDEDEDEDEDEDEDEDEDEDDEDEDEDEDEDEDG:J::455556::::FEDEDEDEDEDEDEDEDEDEDEDEDEDEDDEDEDEDEDEDEDG
FEDEDEDEDEDEDEDEDEDEDEDEDEDEDDEDEDEDEDEDEDG::::455556::::FEDEDEDEDEDEDEDEDEDEDEDEDEDEDDEDEDEDEDEDEDG
FEDEDEDEDEDEDEDEDEDEDEDEDEDEDDEDEDEDEDEDEDG::::455556::::FEDEDEDEDEDEDEDEDEDEDEDEDEDEDDEDEDEDEDEDEDG
FEDEDEDEDEDEDEDEDEDEDEDEDEDEDDEDEDEDEDEDEDG::J:455556::::FEDEDEDEDEDEDEDEDEDEDEDEDEDEDDEDEDEDEDEDEDG
FEDEDEDEDEDEDEDEDEDEDEDEDEDEDDEDEDEDEDEDEDG::::455556:0::FEDEDEDEDEDEDEDEDEDEDEDEDEDEDDEDEDEDEDEDEDG
FEDEDEDEDEDEDEDEDEDEDEDEDEDEDDEDEDEDEDEDEDG::::455556::::FEDEDEDEDEDEDEDEDEDEDEDEDEDEDDEDEDEDEDEDEDG
FEDEDEDEDEDEDEDEDEDEDEDEDEDEDDEDEDEDEDEDEDG::0:455556::::FEDEDEDEDEDEDEDEDEDEDEDEDEDEDDEDEDEDEDEDEDG
FEDEDEDEDEDEDEDEDEDEDEDEDEDEDDEDEDEDEDEDEDG::::455556::::FEDEDEDEDEDEDEDEDEDEDEDEDEDEDDEDEDEDEDEDEDG
FEDEDEDEDEDEDEDEDEDEDEDEDEDEDDEDEDEDEDEDEDG::::455556::::FEDEDEDEDEDEDEDEDEDEDEDEDEDEDDEDEDEDEDEDEDG
FEDEDEDEDEDEDEDEDEDEDEDEDEDEDDEDEDEDEDEDEDG::::455556:::0FEDEDEDEDEDEDEDEDEDEDEDEDEDEDDEDEDEDEDEDEDG
FEDEDEDEDEDEDEDEDEDEDEDEDEDEDDEDEDEDEDEDEDG:0::455556:0::FEDEDEDEDEDEDEDEDEDEDEDEDEDEDDEDEDEDEDEDEDG