0000000000000000000000000000000000000000000000000000000000000000000000000000000000000000000000000000
0000000000000000000000000000000000000000000000000000000000000000000000000000000000000000000000000000
0000000000000000000000000000000000000000000000000000000000000000000000000000000000000000000000000000
0000000000000000000000000000000000000000000000000000000000000000000000000000000000000000000000000000
0000000000000000000000000000000000000000000000000000000000000000000000000000000000000000000000000000
0000000000000000000000000000000000000000000000000000000000000000000000000000000000000000000000000000
0000000000000000000000000000000000000000000000000000000000000000000000000000000000000000000000000000
0000000000000000000000000000000000000000000000000000000000000000000000000000000000000000000000000000
0000000000000000000000000000000000000000000000000000000000000000000000000000000000000000000000000000
0000000000000000000000000000000000000000000000000000000000000000000000000000000000000000000000000000
0000000000000000000000000000000000000000000000000000000000000000000000000000000000000000000000000000
0000000000000000000000000000000000000000000000000000000000000000000000000000000000000000000000000000
0000000000000000000000000000000000000000000000000000000000000000000000000000000000000000000000000000
0000000000000000000000000000000000000000000000000000000000000000000000000000000000000000000000000000
0000000000000000000000000000000000000000000000000000000000000000000000000000000000000000000000000000
0000000000000000000000000000000000000000000000000000000000000000000000000000000000000000000000000000
0000000000000000000000000000000000000000000000000000000000000000000000000000000000000000000000000000
0000000000000000000000000000000000000000000000000000000000000000000000000000000000000000000000000000
0000000000000000000000000000000000000000000000000000000000000000000000000000000000000000000000000000
0000000000000000000000000000000000000000000000000000000000000000000000000000000000000000000000000000
0000000000000000000000000000000000000000000000000000000000000000000000000000000000000000000000000000
0000000000000000000000000000000000000000000000000000000000000000000000000000000000000000000000000000
0000000000000000000000000000000000000000000000000000000000000000000000000000000000000000000000000000
0000000000000000000000000000000000000000000000000000000000000000000000000000000000000000000000000000
0000000000000000000000000000000000000000000000000000000000000000000000000000000000000000000000000000
0000000000000000000000000000000000000000000000000000000000000000000000000000000000000000000000000000
0000000000000000000<<<<<<<<<<<<<<<3<<<<<<<<<<<<<<<<<<<<<<<<<<<<<<<<<<<<<<<<<<<0000000000000000000000
000000000000000000000<<<<<<<<<<<<<<<<<<<<<<<<<<<<<<<<<<<<<<<<<<<<<<<<<<<<<<<000000000000000000000000
00000000000000000000000<<<<<<<<<<<<<<<<<<<<<<<<<<<<<<<<<<<3<<<<<<<<<<<<<<<00000000000000000000000000
0000000000000000000000000<<<<<<<<<<<<3<<<<<<<<<<<<<<<<<<<<<<<<<<<<<<<<<<0000000000000000000000000000
000000000000000000000000000::::::::::::::::::::::b::::::::::::::::::::000000000000000000000000000000
00000000000000000000000000000:::::::::::::::::::::::::::::::::::::::00000000000000000000000000000000
0000000000000000000000000000000:::::::::::::1222223::::::::::::::::000000000000000000000000000000000
000000000000000000000000000000000:::::::::::7555556::::::::::::::00000000000000000000000000000000000
00000000000000000000000000000000000::::::::::75555523::::::::::0000000000000000000000000000000000000
0000000000000000000000000000000000000:::::::::4555559::::::::000000000000000000000000000000000000000
00000000000000000000000000000000000000:::::::1555556:::::::00000000000000000000000000000000000000000
0000000000000000000000000000000000000000:::::4555556::::::::0000000000000000000000000000000000000000
00000000000000000000000000000000000000000::::4555556::::::::0000000000000000000000000000000000000000
0000000000000000000000000000000000000000000::4555556:::::::00000000000000000000000000000000000000000
00000000000000000000000000000000000000000::::4555556:::::::00000000000000000000000000000000000000000
0000000000000000000000000000000000000000:::::4555556:::::::00000000000000000000000000000000000000000
000000000000000000000000000000000000000::::::4555556:::::::00000000000000000000000000000000000000000
00000000000000000000000000000000000000:::::::7555556:::::::00000000000000000000000000000000000000000
0000000000000000000000000000000000000000::::::785555223:::::::00000000000000000000000000000000000000
0000000000000000000000000000000000000000000:::::7555556::::::::0000000000000000000000000000000000000
0000000000000000000000000000000000000000:::::::::455556::::::000000000000000000000000000000000000000
0000000000000000000000000000000000000000::::::::1555556:::::::00000000000000000000000000000000000000
00000000000000000000000000000000000000000:::::::4555556::::::000000000000000000000000000000000000000
000000000000000000000000000000000000000000::::::4555556:::::::00000000000000000000000000000000000000
00000000000000000000000000000000000000000:::::::4555559:::::::00000000000000000000000000000000000000
0000000000000000000000000000000000000000:::::::1555559:::::::000000000000000000000000000000000000000
000000000000000000000000000000000000000:::::::1555556:::::::0000000000000000000000000000000000000000
000000000000000000000000000000000000000:::::::4555556:::::::0000000000000000000000000000000000000000
000000000000000000000000000000000000000:::::::4555d56:::::::0000000000000000000000000000000000000000
000000000000000000000000000000000000000:::::::7555556:::::::::00000000000000000000000000000000000000
0000000000000000000000000000000000000000:::::::4555553::::::::00000000000000000000000000000000000000
000000000000000000000000000000000000000:::::::45555556::::::0000000000000000000000000000000000000000
000000000000000000000000000000000000000000:::::::45555223:::::::000000000000000000000000000000000000
000000000000000000000000000000000000000000000:::::::45555553:::::00000000000000000000000000000000000
00000000000000000000000000000000000000000000000000:::::::4552223:::::::::000000000000000000000000000
000000000000000000000000000000000000000000000000000000::::::45552223:::::::::00000000000000000000000
00000000000000000000000000000000000000000000000000000000:::::::45555223::::::::000000000000000000000
00000000000000000000000000000000000000000000000000000000000:::::::455553::::::::00000000000000000000
00000000000000000000000000000000000000000000000000000000000000000:::45553::::::::0000000000000000000
00000000000000000000000000000000000000000000000::::1222223::::00000:455553::::::::000000000000000000
00000000000000000000000000000000000000000000::::::155555553::::000::::4556:::::::0000000000000000000
00000000000000000000000000000000000000000000::::::455885556:::::0:::425556::::::00000000000000000000
000000000000000000000000000000000000000000::::::1258900755523::000::755556:::::::0000000000000000000
000000000000000000000000000000000000000::::::122559::0::455556:00000:455553:::::00000000000000000000
00000000000000000000000000000000000000::::::155559::00::455556::000::455d59::::000000000000000000000
0000000000000000000000000000000000000::::::155556:::000:788550:::00:155559:::::000000000000000000000
0000000000000000000000000000000000000::::::455559:::0000:::755556:0:455559::::0000000000000000000000
000000000000000000000000000000000000:::::::45556:::::0000::::755562255559:::::0000000000000000000000
0000000000000000000000000000000000000::::::755553:::::000:::::75555555559:::::::00000000000000000000
00000000000000000000000000000000000000::::::45556::::::000:::::755555559:::::::000000000000000000000
0000000000000000000000000000000000000::::::1d55589::::00000:::::7888889:::::000000000000000000000000
00000000000000000000000000000000000::::::125559:::::::0000000000::::::::::00000000000000000000000000
0000000000000000000000000000000000::::::155559:::::::0000000000000::::000000000000000000000000000000
000000000000000000000000000000000::::::155559:::::::000000000000000::0000000000000000000000000000000
00000000000000000000000000000000::::::155559:::::::0000000000000000000000000000000000000000000000000
0000000000000000000000000000000::::::155559:::::::00000000000000000000000000000000000000000000000000
000000000000000000000000000000:::::::45556:::::::000000000000000000000000000000000000000000000000000
0000000000000000000000000000000::::::455553:::::::00000000000000000000000000000000000000000000000000
000000000000000000000::::::::::::::::45P5b6::::::::::::::::00000000000000000000000000000000000000000
00000000000000000000:::::::::::::::::788889:::::::::::::::::0000000000000000000000000000000000000000
0000000000000000000::::::::::::::::::::::::::::::::::::::::::000000000000000000000000000000000000000
000000000000000000::::::::::::::::::::::::::::::::::::::::::::00000000000000000000000000000000000000
0000000000000000000000000000000000000000000000000000000000000000000000000000000000000000000000000000
0000000000000000000000000000000000000000000000000000000000000000000000000000000000000000000000000000
0000000000000000000000000000000000000000000000000000000000000000000000000000000000000000000000000000
0000000000000000000000000000000000000000000000000000000000000000000000000000000000000000000000000000
0000000000000000000000000000000000000000000000000000000000000000000000000000000000000000000000000000
0000000000000000000000000000000000000000000000000000000000000000000000000000000000000000000000000000
0000000000000000000000000000000000000000000000000000000000000000000000000000000000000000000000000000
0000000000000000000000000000000000000000000000000000000000000000000000000000000000000000000000000000
0000000000000000000000000000000000000000000000000000000000000000000000000000000000000000000000000000
0000000000000000000000000000000000000000000000000000000000000000000000000000000000000000000000000000
0000000000000000000000000000000000000000000000000000000000000000000000000000000000000000000000000000
0000000000000000000000000000000000000000000000000000000000000000000000000000000000000000000000000000