0000000000000000000000000000000000000000000000000000000000000000000000000000000000000000000000000000
0000000000000000000000000000000000000000000000000000000000000000000000000000000000000000000000000000
0000000000000000000000000000000000000000000000000000000000000000000000000000000000000000000000000000
0000000000000000000000000000000000000000000000000000000000000000000000000000000000000000000000000000
0000000000000000000000000000000000000000000000000000000000000000000000000000000000000000000000000000
0000000000000000000000000000000000000000000000000000000000000000000000000000000000000000000000000000
0000000000000000000000000000000000000000000000000000000000000000000000000000000000000000000000000000
0000000000000000000000000000000000000000000000000000000000000000000000000000000000000000000000000000
0000000000000000000000000000000000000000000000000000000000000000000000000000000000000000000000000000
0000000000000000000000000000000000000000000000000000000000000000000000000000000000000000000000000000
0000000000000000000000000000000000000000000000000000000000000000000000000000000000000000000000000000
0000000000000000000000000000000000000000000000000000000000000000000000000000000000000000000000000000
0000000000000000000000000000000000000000000000000000000000000000000000000000000000000000000000000000
0000000000000000000000000000000000000000000000000000000000000000000000000000000000000000000000000000
0000000000000000000000000000000000000000000000000000000000000000000000000000000000000000000000000000
0000000000000000000000000000000000000000000000000000000000000000000000000000000000000000000000000000
0000000000000000000000000000000000000000000000000000000000000000000000000000000000000000000000000000
0000000000000000000000000000000000000000000000000000000000000000000000000000000000000000000000000000
0000000000000000000000000000000000000000000000000000000000000000000000000000000000000000000000000000
0000000000000000000000000000000000000000000000000000000000000000000000000000000000000000000000000000
0000000000000000000000000000000000000000000000000000000000000000000000000000000000000000000000000000
0000000000000000000000000000000000000000000000000000000000000000000000000000000000000000000000000000
0000000000000000000000000000000000000000000000000000000000000000000000000000000000000000000000000000
0000000000000000000000000000000000000000000000000000000000000000000000000000000000000000000000000000
0000000000000000000000000000000000000000000000000000000000000000000000000000000000000000000000000000
0000000000000000000000000000000000000000000000000000000000000000000000000000000000000000000000000000
00000000000000000000000000000000000000<<<<<<<<<<<<<<<<<<<<<<<<<<<<<<<<<<<<00000000000000000000000000
00000000000000000000000000000000000000<<<<<<<<<<<<<<<<<<<<<<<<<<<<<<<<<<<<00000000000000000000000000
00000000000000000000000000000000000000<<<<<<<<<<<<<<<<<<<<<<<<<<<<<<<<<<<<00000000000000000000000000
00000000000000000000000000000000000000<<<<<<<<<<<<<<<<<<<<<<<<<<<<<<<<<<<<00000000000000000000000000
0000000000000000000000000000000000000000000:::::::::::::::::0000000000000000000000000000000000000000
00000000000000000000000000000000000000000000:::::::::::::::::000000000000000000000000000000000000000
00000000000000000000000000000000000000000000:::::::::::::::::000000000000000000000000000000000000000
00000000000000000000000000000000000000000000:::::::::::::::::000000000000000000000000000000000000000
00000000000000000000000000000000000000000000:::::::::::::::::000000000000000000000000000000000000000
00000000000000000000000000000000000000000000::::b::::::::::::000000000000000000000000000000000000000
000000000000000000000000000000000000000000000055555::::::::00000000000000000000000000000000000000000
000000000000000000000000000000000000000000000555550::::::::00000000000000000000000000000000000000000
000000000000000000000000000000000000000000000555550::::::::00000000000000000000000000000000000000000
000000000000000000000000000000000000000000000055555::::::::00000000000000000000000000000000000000000
000000000000000000000000000000000000000000000055555::::::::00000000000000000000000000000000000000000
000000000000000000000000000000000000000000000055555::::::::00000000000000000000000000000000000000000
000000000000000000000000000000000000000000000055555::::::::00000000000000000000000000000000000000000
000000000000000000000000000000000000000000000055555::::::::00000000000000000000000000000000000000000
00000000000000000000000000000000000000000000005555555::::::::000000000000000000000000000000000000000
0000000000000000000000000000000000000000000000000055555::::::::0000000000000000000000000000000000000
0000000000000000000000000000000000000000000000000055d5::::::::00000000000000000000000000000000000000
000000000000000000000000000000000000000000000000055555::::::::00000000000000000000000000000000000000
000000000000000000000000000000000000000000000000055555::::::::00000000000000000000000000000000000000
00000000000000000000000000000000000000000000000055555::::::::000000000000000000000000000000000000000
000000000000000000000000000000000000000000000000055555::::::::00000000000000000000000000000000000000
00000000000000000000000000000000000000000000000055555::::::::000000000000000000000000000000000000000
0000000000000000000000000000000000000000000000055555::::::::0000000000000000000000000000000000000000
0000000000000000000000000000000000000000000000055555::::::::0000000000000000000000000000000000000000
0000000000000000000000000000000000000000000000055555::::::::0000000000000000000000000000000000000000
0000000000000000000000000000000000000000000000055555::::::::0000000000000000000000000000000000000000
00000000000000000000000000000000000000000000000555555::::::::000000000000000000000000000000000000000
00000000000000000000000000000000000000000000000555555::::::::000000000000000000000000000000000000000
00000000000000000000000000000000000000000000000555555::::::::000000000000000000000000000000000000000
0000000000000000000000000000000000000000000000000000555555::::::::0000000000000000000000000000000000
00000000000000000000000000000000000000000000000000000000555555::::::::000000000000000000000000000000
0000000000000000000000000000000000000000000000000000000000000555555::::::::0000000000000000000000000
0000000000000000000000000000000000000000000000000000000000000000555555::::::::0000000000000000000000
00000000000000000000000000000000000000000000000000000000000000000005555::::::::000000000000000000000
0000000000000000000000000000000000000000000000000000000000000000000005555000000000000000000000000000
0000000000000000000000000000000000000000000000000000000000000000000005555::::::::0000000000000000000
0000000000000000000000000000000000000000000000000000000000000000000005555::::::::0000000000000000000
0000000000000000000000000000000000000000000000000005555555::::::0::::5555::::::::0000000000000000000
000000000000000000000000000000000000000000000000055500005555:::000:::5555::::::::0000000000000000000
0000000000000000000000000000000000000000000000555500000005555000000005555::::::::0000000000000000000
000000000000000000000000000000000000000000000555500000000555500000000055d5::::::::000000000000000000
0000000000000000000000000000000000000000000055550000000005555000000005555::::::::0000000000000000000
000000000000000000000000000000000000000000005555::::0000::::5555000005555::::::::0000000000000000000
000000000000000000000000000000000000000000055550000000000000055550005555::::::::00000000000000000000
000000000000000000000000000000000000000000005555::::::::0::::::::5555555::::::::00000000000000000000
0000000000000000000000000000000000000000000005555::::::000::::::5555555::::::::000000000000000000000
0000000000000000000000000000000000000:::::::5555:::::::00000::::::::::::::::::::00000000000000000000
00000000000000000000000000000000000:::::::5555::::::::0000000000000000000000000000000000000000000000
0000000000000000000000000000000000:::::::5555::::::::00000000000000000000000000000000000000000000000
000000000000000000000000000000000:::::::5555::::::::000000000000000000000000000000000000000000000000
00000000000000000000000000000000:::::::5555::::::::0000000000000000000000000000000000000000000000000
0000000000000000000000000000000:::::::5555::::::::00000000000000000000000000000000000000000000000000
000000000000000000000000000000:::::::5555::::::::000000000000000000000000000000000000000000000000000
0000000000000000000000000000000:::::::5555::::::::00000000000000000000000000000000000000000000000000
000000000000000000000:::::::::::::::::5Pb5:::::::::::::::::00000000000000000000000000000000000000000
00000000000000000000000000000000::::::::::::::::::00000000000000000000000000000000000000000000000000
00000000000000000000000000000000::::::::::::::::::00000000000000000000000000000000000000000000000000
00000000000000000000000000000000::::::::::::::::::00000000000000000000000000000000000000000000000000
0000000000000000000000000000000000000000000000000000000000000000000000000000000000000000000000000000
0000000000000000000000000000000000000000000000000000000000000000000000000000000000000000000000000000
0000000000000000000000000000000000000000000000000000000000000000000000000000000000000000000000000000
0000000000000000000000000000000000000000000000000000000000000000000000000000000000000000000000000000
0000000000000000000000000000000000000000000000000000000000000000000000000000000000000000000000000000
0000000000000000000000000000000000000000000000000000000000000000000000000000000000000000000000000000
0000000000000000000000000000000000000000000000000000000000000000000000000000000000000000000000000000
0000000000000000000000000000000000000000000000000000000000000000000000000000000000000000000000000000
0000000000000000000000000000000000000000000000000000000000000000000000000000000000000000000000000000
0000000000000000000000000000000000000000000000000000000000000000000000000000000000000000000000000000
0000000000000000000000000000000000000000000000000000000000000000000000000000000000000000000000000000
0000000000000000000000000000000000000000000000000000000000000000000000000000000000000000000000000000