0000000000000000000000000000000000000000000000000000000000000000000000000000000000000000000000000000
0000000000000000000000000000000000000000000000000000000000000000000000000000000000000000000000000000
0000000000000000000000000000000000000000000000000000000000000000000000000000000000000000000000000000
0000000000000000000000000000000000000000000000000000000000000000000000000000000000000000000000000000
0000000000000000000000000000000000000000000000000000000000000000000000000000000000000000000000000000
0000000000000000000000000000000000000000000000000000000000000000000000000000000000000000000000000000
0000000000000000000000000000000000000000000000000000000000000000000000000000000000000000000000000000
0000000000000000000000000000000000000000000000000000000000000000000000000000000000000000000000000000
::::::::::::::::::::::::::::::::::::::::::::::::::::::::::::::::::::::::::::::::::::::::::::::::::::
:::<<<<<<<<<<<<<<<<<<<<<<<<<<<<<<<<<<<<<<<<<<<<<<<<<<<<<<<<<<<<<<<<<<<<<<<<<<<<<<<<<<<<<<<<<<<<<::::
::::<<<<<<<<<<<<<<<<<<<<<<<<<<<<<<<<<<<<<<<<<<<<<<<<<<<<<<<<<<<<<<<<<<<<<<<<<<<<<<<<<<<<<<<<<<<:::::
::::<<<<<<<<<<<<<<<<<<<<<<<<<<<<<<<<<<<<<<<<<<<<<<<<<<<<<<<<<<<<<<<<<<<<<<<<<<<<<<<<<<<<<<<<<:::::::
:::::<<<<<<<<<<<<<<<<<<<<<<<<<<<<<<<<<<<<<<<<<<<<<<<<<<<<<<<<<<<<<<<<<<<<<<<<<<<<<<<<<<<<<<<::::::::
::::::<<<<<<<<<<<<<<<<<<<<<<<<<<<<<<<<<<<<<<<<<<<<<<<<<<<<<<<<<<<<<<<<<<<<<<<<<<<<<<<<<<<<<:::::::::
:::::::<<<<<<<<<<<<<<<<<<<<<<<<<<<<<<<<<<<<<<<<<<<<<<<<<<<<<<<<<<<<<<<<<<<<<<<<<<<<<<<<<<<::::::::::
::::::::<<<<<<<<<<<<<<<<<<<<<<<<<<<<<<<<<<<<<<<<00<<<<<<<<<<<<<<<<<<<<<<<<<<<<<<<<<<<<<<<:::::::::::
:::::::::<<<<<<<<<<<<<<<<<<<<<<<<<<<<<<<<<<<0<<0<<0<<<<<<<<<<<<<<<<<<<<<<<<<<<<<<<<<<<<<::::::::::::
=AAAAAAAAAAAAAAAAAAAAAAAAAAAAAAAAAAAAAAAAA?0000000b000000=AAAAAAAAAAAAAAAAAAAAAAAAAAAAAAAAAAAAAAAAA?
FEDEDEDEDEDEDEDEDEDEDEDEDEDEDDEDEDEDEDEDEDG::::000::0::::FEDEDEDEDEDEDEDEDEDEDEDEDEDEDDEDEDEDEDEDEDG
FEDEDEDEDEDEDEDEDEDEDEDEDEDEDDEDEDEDEDEDEDG::::122223::::FEDEDEDEDEDEDEDEDEDEDEDEDEDEDDEDEDEDEDEDEDG
FEDEDEDEDEDEDEDEDEDEDEDEDEDEDDEDEDEDEDEDEDG::::455556::::FEDEDEDEDEDEDEDEDEDEDEDEDEDEDDEDEDEDEDEDEDG
FEDEDEDEDEDEDEDEDEDEDEDEDEDEDDEDEDEDEDEDEDG::::455556::::FEDEDEDEDEDEDEDEDEDEDEDEDEDEDDEDEDEDEDEDEDG
FEDEDEDEDEDEDEDEDEDEDEDEDEDEDDEDEDEDEDEDEDG::::455556::::FEDEDEDEDEDEDEDEDEDEDEDEDEDEDDEDEDEDEDEDEDG
FEDEDEDEDEDEDEDEDEDEDEDEDEDEDDEDEDEDEDEDEDG::::455556::::FEDEDEDEDEDEDEDEDEDEDEDEDEDEDDEDEDEDEDEDEDG
FEDEDEDEDEDEDEDEDEDEDEDEDEDEDDEDEDEDEDEDEDG::::455556::::FEDEDEDEDEDEDEDEDEDEDEDEDEDEDDEDEDEDEDEDEDG
FEDEDEDEDEDEDEDEDEDEDEDEDEDEDDEDEDEDEDEDEDG::::455556:0::FEDEDEDEDEDEDEDEDEDEDEDEDEDEDDEDEDEDEDEDEDG
FEDEDEDEDEDEDEDEDEDEDEDEDEDEDDEDEDEDEDEDEDG::::455556::::FEDEDEDEDEDEDEDEDEDEDEDEDEDEDDEDEDEDEDEDEDG
FEDEDEDEDEDEDEDEDEDEDEDEDEDEDDEDEDEDEDEDEDG::::455556::::FEDEDEDEDEDEDEDEDEDEDEDEDEDEDDEDEDEDEDEDEDG
FEDEDEDEDEDEDEDEDEDEDEDEDEDEDDEDEDEDEDEDEDG::::455556::::FEDEDEDEDEDEDEDEDEDEDEDEDEDEDDEDEDEDEDEDEDG
FEDEDEDEDEDEDEDEDEDEDEDEDEDEDDEDEDEDEDEDEDG::::455556::::FEDEDEDEDEDEDEDEDEDEDEDEDEDEDDEDEDEDEDEDEDG
FEDEDEDEDEDEDEDEDEDEDEDEDEDEDDEDEDEDEDEDEDG::::455556:::0FEDEDEDEDEDEDEDEDEDEDEDEDEDEDDEDEDEDEDEDEDG
FEDEDEDEDEDEDEDEDEDEDEDEDEDEDDEDEDEDEDEDEDG::::455556:0::FEDEDEDEDEDEDEDEDEDEDEDEDEDEDDEDEDEDEDEDEDG
FEDEDEDEDEDEDEDEDEDEDEDEDEDEDDEDEDEDEDEDEDG::::455556::::FEDEDEDEDEDEDEDEDEDEDEDEDEDEDDEDEDEDEDEDEDG
FEDEDEDEDEDEDEDEDEDEDEDEDEDEDDEDEDEDEDEDEDG::::455556::::FEDEDEDEDEDEDEDEDEDEDEDEDEDEDDEDEDEDEDEDEDG
FEDEDEDEDEDEDEDEDEDEDEDEDEDEDDEDEDEDEDEDEDG::::455556::0:FEDEDEDEDEDEDEDEDEDEDEDEDEDEDDEDEDEDEDEDEDG
FEDEDEDEDEDEDEDEDEDEDEDEDEDEDDEDEDEDEDEDEDG::::455556::::FEDEDEDEDEDEDEDEDEDEDEDEDEDEDDEDEDEDEDEDEDG
FEDEDEDEDEDEDEDEDEDEDEDEDEDEDDEDEDEDEDEDEDG::::455556::::FEDEDEDEDEDEDEDEDEDEDEDEDEDEDDEDEDEDEDEDEDG
FEDEDEDEDEDEDEDEDEDEDEDEDEDEDDEDEDEDEDEDEDG::::455556:::0FEDEDEDEDEDEDEDEDEDEDEDEDEDEDDEDEDEDEDEDEDG
FEDEDEDEDEDEDEDEDEDEDEDEDEDEDDEDEDEDEDEDEDG::::455556::::FEDEDEDEDEDEDEDEDEDEDEDEDEDEDDEDEDEDEDEDEDG
FEDEDEDEDEDEDEDEDEDEDEDEDEDEDDEDEDEDEDEDEDG::::455556::::FEDEDEDEDEDEDEDEDEDEDEDEDEDEDDEDEDEDEDEDEDG
FEDEDEDEDEDEDEDEDEDEDEDEDEDEDDEDEDEDEDEDEDG::::455556:0::FEDEDEDEDEDEDEDEDEDEDEDEDEDEDDEDEDEDEDEDEDG
FEDEDEDEDEDEDEDEDEDEDEDEDEDEDDEDEDEDEDEDEDG::::455556::::FEDEDEDEDEDEDEDEDEDEDEDEDEDEDDEDEDEDEDEDEDG
FEDEDEDEDEDEDEDEDEDEDEDEDEDEDDEDEDEDEDEDEDG::::455556::::FEDEDEDEDEDEDEDEDEDEDEDEDEDEDDEDEDEDEDEDEDG
FEDEDEDEDEDEDEDEDEDEDEDEDEDEDDEDEDEDEDEDEDG::::4555560:::FEDEDEDEDEDEDEDEDEDEDEDEDEDEDDEDEDEDEDEDEDG
FEDEDEDEDEDEDEDEDEDEDEDEDEDEDDEDEDEDEDEDEDG::::455556::::FEDEDEDEDEDEDEDEDEDEDEDEDEDEDDEDEDEDEDEDEDG
FEDEDEDEDEDEDEDEDEDEDEDEDEDEDDEDEDEDEDEDEDG::::455556::::FEDEDEDEDEDEDEDEDEDEDEDEDEDEDDEDEDEDEDEDEDG
FEDEDEDEDEDEDEDEDEDEDEDEDEDEDDEDEDEDEDEDEDG::::455556:0::FEDEDEDEDEDEDEDEDEDEDEDEDEDEDDEDEDEDEDEDEDG
FEDEDEDEDEDEDEDEDEDEDEDEDEDEDDEDEDEDEDEDEDG::::455556::::FEDEDEDEDEDEDEDEDEDEDEDEDEDEDDEDEDEDEDEDEDG
FEDEDEDEDEDEDEDEDEDEDEDEDEDEDDEDEDEDEDEDEDG::::455556::::FEDEDEDEDEDEDEDEDEDEDEDEDEDEDDEDEDEDEDEDEDG
FEDEDEDEDEDEDEDEDEDEDEDEDEDEDDEDEDEDEDEDEDG::::455556::::FEDEDEDEDEDEDEDEDEDEDEDEDEDEDDEDEDEDEDEDEDG
FEDEDEDEDEDEDEDEDEDEDEDEDEDEDDEDEDEDEDEDEDG::::455556::0:FEDEDEDEDEDEDEDEDEDEDEDEDEDEDDEDEDEDEDEDEDG
FEDEDEDEDEDEDEDEDEDEDEDEDEDEDDEDEDEDEDEDEDG::::455556::::FEDEDEDEDEDEDEDEDEDEDEDEDEDEDDEDEDEDEDEDEDG
FEDEDEDEDEDEDEDEDEDEDEDEDEDEDDEDEDEDEDEDEDG::::455556::::FEDEDEDEDEDEDEDEDEDEDEDEDEDEDDEDEDEDEDEDEDG
FEDEDEDEDEDEDEDEDEDEDEDEDEDEDDEDEDEDEDEDEDG::::455556::::FEDEDEDEDEDEDEDEDEDEDEDEDEDEDDEDEDEDEDEDEDG
FEDEDEDEDEDEDEDEDEDEDEDEDEDEDDEDEDEDEDEDEDG0:::455d56:::0FEDEDEDEDEDEDEDEDEDEDEDEDEDEDDEDEDEDEDEDEDG
FEDEDEDEDEDEDEDEDEDEDEDEDEDEDDEDEDEDEDEDEDG:0::455556::0:>CBCBCBCBCBCBCBCBCBCBCBCBCBCBCBCBCBCBCBCBC@
FEDEDEDEDEDEDEDEDEDEDEDEDEDEDDEDEDEDEDEDEDG::0:45555530:::::::::::::::::::::::::::::::::::::::::::::
FEDEDEDEDEDEDEDEDEDEDEDEDEDEDDEDEDEDEDEDEDG:::07855556000:::::::::::::::::::::::::::::::::::::::::::
FEDEDEDEDEDEDEDEDEDEDEDEDEDEDDEDEDEDEDEDEDG:::::078855223000::::::::::::::::::::::::::::::::::::::::
FEDEDEDEDEDEDEDEDEDEDEDEDEDEDDEDEDEDEDEDEDG::::::000788882230000:::::::::::=AAAAAAAAAAAAAAAAAAAAAAA?
FEDEDEDEDEDEDEDEDEDEDEDEDEDEDDEDEDEDEDEDEDG::::::::::000078822230000:::::::FEDEDEDEDEDEDDEDEDEDEDEDG
FEDEDEDEDEDEDEDEDEDEDEDEDEDEDDEDEDEDEDEDEDG::::::::::::::00078852223000::::FEDEDEDEDEDEDDEDEDEDEDEDG
FEDEDEDEDEDEDEDEDEDEDEDEDEDEDDEDEDEDEDEDEDG::::::::::::::::::00788552230:::FEDEDEDEDEDEDDEDEDEDEDEDG
FEDEDEDEDEDEDEDEDEDEDEDEDEDEDDEDEDEDEDEDEDG::::::::::::::::::::0007855530::FEDEDEDEDEDEDDEDEDEDEDEDG
FEDEDEDEDEDEDEDEDEDEDEDEDEDEDDEDEDEDEDEDEDG::::::::0000000::::::::00455530:FEDEDEDEDEDEDDEDEDEDEDEDG
FEDEDEDEDEDEDEDEDEDEDEDEDEDEDDEDEDEDEDEDEDG:::::::012222230::::::::07855530FEDEDEDEDEDEDDEDEDEDEDEDG
FEDEDEDEDEDEDEDEDEDEDEDEDEDEDDEDEDEDEDEDEDG::::::01555555530::::::::0045560FEDEDEDEDEDEDDEDEDEDEDEDG
FEDEDEDEDEDEDEDEDEDEDEDEDEDEDDEDEDEDEDEDEDG00:::004558855560:::::::01255560>CBCBCBCBCBCBCBCBCBCBCBC@
FEDEDEDEDEDEDEDEDEDEDEDEDEDEDDEDEDEDEDEDEDG::00012589007555230:::::0755555222222222222230:::::::::::
FEDEDEDEDEDEDEDEDEDEDEDEDEDEDDEDEDEDEDEDEDG::12255900::04555530:::::045555588888888888890:::::::::::
FEDEDEDEDEDEDEDEDEDEDEDEDEDEDDEDEDEDEDEDEDG:1555590::::04555590:::::0455d59=AAAAAAAAAAAAAAAAAAAAAAA?
FEDEDEDEDEDEDEDEDEDEDEDEDEDEDDEDEDEDEDEDEDG1555560:::::0788560000::0155556:FEDEDEDEDEDEDEDEDEDEDEDEG
FEDEDEDEDEDEDEDEDEDEDEDEDEDEDDEDEDEDEDEDEDG4555590::::0:000782223000455559:FEDEDEDEDEDEDEDEDEDEDEDEG
>CBCBCBCBCBCBCBCBCBCBCBCBCBCBCBCBCBCBCBCBC@455560:::::::::::07555222555560:FEDEDEDEDEDEDEDEDEDEDEDEG
::::::::::::::::::::::::::::::::::::::::::07555530:::::::::::0755555555590:FEDEDEDEDEDEDEDEDEDEDEDEG
:::::::::::::::::::::::::::::::::::::::::::0455560::::::::::::07555555590::FEDEDEDEDEDEDEDEDEDEDEDEG
:::::::::::::::::::::::::::::::::::::::::001d55890:::::::::::::078888890:::FEDEDEDEDEDEDEDEDEDEDEDEG
::::::::::::::::::::::::::::::::::::::::012555900:::::::::::::::0000000::::FEDEDEDEDEDEDEDEDEDEDEDEG
:::::::::::::::::::::::::::::::::::::::01555590::::::::::::::::::::::::::::FEDEDEDEDEDEDEDEDEDEDEDEG
::::::::::::::::::::::::::::::::::::::01555590:::::::::::::::::::::::::::::FEDEDEDEDEDEDEDEDEDEDEDEG
:::::::::::::::::::::::::::::::::::::01555590::::::::::::::::::::::::::::::FEDEDEDEDEDEDEDEDEDEDEDEG
::::::::::::::::::::::::::::::::::::01555590:::::::::::::::::::::::::::::::FEDEDEDEDEDEDEDEDEDEDEDEG
::::::::::::::::::::::::::::::::::::0455560::::::::::::::::::::::::::::::::FEDEDEDEDEDEDEDEDEDEDEDEG
::::::::::::::::::::::::::::::::::::04555530:::::::::::::::::::::::::::::::FEDEDEDEDEDEDEDEDEDEDEDEG
::::::::::::::::::::::::::::::::::::045P5b600000000000000000000000000000000>CBCBCBCBCBCBCBCBCBCBCBC@
::::::::::::::::::::::::::::::::::::0755555222222222222222222222222222222222222222230:::::::::::::::
:::::::::::::::::::::::::::::::::::::075588888888888888888888888888888888888888888890:::::::::::::::
=AAAAAAAAAAAAAAAAAAAAAAAAAAAAAAAAAAAAA?46=AAAAAAAAAAAAAAAAAAAAAAAAAAAAAAAAAAAAAAAAAAAAAAAAAAAAAAAAA?
FEDEDEDEDEDEDEDEDEDEDEDEDEDEDDEDEDEDEDG46FEDEDEDEDEDEDEDEDEDEDEDEDEDEDDEDEDEDEDEDEDEDEDEDEDEDEDEDEDG
FEDEDEDEDEDEDEDEDEDEDEDEDEDEDDEDEDEDEDG46FEDEDEDEDEDEDEDEDEDEDEDEDEDEDDEDEDEDEDEDEDEDEDEDEDEDEDEDEDG
FEDEDEDEDEDEDEDEDEDEDEDEDEDEDDEDEDEDEDG46FEDEDEDEDEDEDEDEDEDEDEDEDEDEDDEDEDEDEDEDEDEDEDEDEDEDEDEDEDG
FEDEDEDEDEDEDEDEDEDEDEDEDEDEDDEDEDEDEDG46FEDEDEDEDEDEDEDEDEDEDEDEDEDEDDEDEDEDEDEDEDEDEDEDEDEDEDEDEDG
FEDEDEDEDEDEDEDEDEDEDEDEDEDEDDEDEDEDEDG46FEDEDEDEDEDEDEDEDEDEDEDEDEDEDDEDEDEDEDEDEDEDEDEDEDEDEDEDEDG
FEDEDEDEDEDEDEDEDEDEDEDEDEDEDDEDEDEDEDG79>CBCBCBCBCBCBCBCBCBCBCBCBCBCBCBCBCBCBCBCBCBCBCBCBCBCBCBCBC@
FEDEDEDEDEDEDEDEDEDEDEDEDEDEDDEDEDEDEDG:::::::::::::::::::::::::::::::::::::::::::::::::::::::::::::
FEDEDEDEDEDEDEDEDEDEDEDEDEDEDDEDEDEDEDG:::::::::::::::::::::::::::::::::::::::::::::::::::::::::::::
FEDEDEDEDEDEDEDEDEDEDEDEDEDEDDEDEDEDEDG:::::::::::::::::::::::::::::::::::::::::::::::::::::::::::::
FEDEDEDEDEDEDEDEDEDEDEDEDEDEDDEDEDEDEDG:::::::::::::::::::::::::::::::::::::::::::::::::::::::::::::
FEDEDEDEDEDEDEDEDEDEDEDEDEDEDDEDEDEDEDG:::::::::::::::::::::::::::::::::::::::::::::::::::::::::::::
::::::::::::::::::::::::::::::::::::::::::::::::::::::::::::::::::::::::::::::::::::::::::::::::::::
::::::::::::::::::::::::::::::::::::::::::::::::::::::::::::::::::::::::::::::::::::::::::::::::::::
::::::::::::::::::::::::::::::::::::::::::::::::::::::::::::::::::::::::::::::::::::::::::::::::::::